GEOID,,Median Household Income Black,Median Household Total Population,Perc Diff MHHI,Abs Diff MHHI,Location,Congressional District,State,CD_GEO_ID,NAME,State,GEO_ID,B02001_001E,B02001_003E,Perc Diff Pop,Abs Diff Pop,Perc Pop
101,0,26956,44824,0.6628579908,17868,"Congressional District 1 (115th Congress), Alabama",1,1,101,Congressional District 1,Alabama,5001500US0101,699597,194080,-0.7225831443,-505517,0.2774168557
102,1,29348,43173,0.4710712825,13825,"Congressional District 2 (115th Congress), Alabama",2,1,102,Congressional District 2,Alabama,5001500US0102,683013,210862,-0.69127674,-472151,0.30872326
103,2,30393,42953,0.4132530517,12560,"Congressional District 3 (115th Congress), Alabama",3,1,103,Congressional District 3,Alabama,5001500US0103,700551,178003,-0.7459100051,-522548,0.2540899949
104,3,28789,40267,0.3986939456,11478,"Congressional District 4 (115th Congress), Alabama",4,1,104,Congressional District 4,Alabama,5001500US0104,683607,47540,-0.9304571194,-636067,0.06954288063
105,4,35509,51830,0.459629953,16321,"Congressional District 5 (115th Congress), Alabama",5,1,105,Congressional District 5,Alabama,5001500US0105,704796,121575,-0.8275032775,-583221,0.1724967225
106,5,46713,60706,0.2995525871,13993,"Congressional District 6 (115th Congress), Alabama",6,1,106,Congressional District 6,Alabama,5001500US0106,694370,101997,-0.8531085732,-592373,0.1468914268
107,6,27167,33366,0.2281812493,6199,"Congressional District 7 (115th Congress), Alabama",7,1,107,Congressional District 7,Alabama,5001500US0107,675230,427996,-0.3661478311,-247234,0.6338521689
200,7,53800,74444,0.3837174721,20644,"Congressional District (at Large) (115th Congress), Alaska",0,2,200,Congressional District (at Large),Alaska,5001500US0200,736855,24443,-0.9668279377,-712412,0.03317206235
401,8,50520,48583,-0.03834125099,-1937,"Congressional District 1 (115th Congress), Arizona",1,4,401,Congressional District 1,Arizona,5001500US0401,735985,17121,-0.9767372976,-718864,0.02326270236
402,9,36736,48125,0.3100228659,11389,"Congressional District 2 (115th Congress), Arizona",2,4,402,Congressional District 2,Arizona,5001500US0402,720794,29891,-0.9585304539,-690903,0.04146954608
403,10,44424,42173,-0.05067080857,-2251,"Congressional District 3 (115th Congress), Arizona",3,4,403,Congressional District 3,Arizona,5001500US0403,739672,34504,-0.9533522967,-705168,0.04664770331
404,11,51497,45933,-0.1080451288,-5564,"Congressional District 4 (115th Congress), Arizona",4,4,404,Congressional District 4,Arizona,5001500US0404,738648,13422,-0.9818289632,-725226,0.01817103681
405,12,60921,68292,0.1209927611,7371,"Congressional District 5 (115th Congress), Arizona",5,4,405,Congressional District 5,Arizona,5001500US0405,765403,22784,-0.9702326748,-742619,0.02976732519
406,13,41136,64223,0.5612359004,23087,"Congressional District 6 (115th Congress), Arizona",6,4,406,Congressional District 6,Arizona,5001500US0406,752459,20352,-0.9729526791,-732107,0.02704732085
407,14,29879,36097,0.2081060276,6218,"Congressional District 7 (115th Congress), Arizona",7,4,407,Congressional District 7,Arizona,5001500US0407,767495,74685,-0.9026899198,-692810,0.0973100802
408,15,53239,60342,0.1334172317,7103,"Congressional District 8 (115th Congress), Arizona",8,4,408,Congressional District 8,Arizona,5001500US0408,753310,33771,-0.9551698504,-719539,0.04483014961
409,16,34613,52245,0.5094039812,17632,"Congressional District 9 (115th Congress), Arizona",9,4,409,Congressional District 9,Arizona,5001500US0409,754811,40580,-0.9462381974,-714231,0.05376180262
501,17,23858,38289,0.6048704837,14431,"Congressional District 1 (115th Congress), Arkansas",1,5,501,Congressional District 1,Arkansas,5001500US0501,724990,130344,-0.8202126926,-594646,0.1797873074
502,18,33192,48103,0.4492347554,14911,"Congressional District 2 (115th Congress), Arkansas",2,5,502,Congressional District 2,Arkansas,5001500US0502,754821,167337,-0.7783090296,-587484,0.2216909704
503,19,31311,46332,0.4797355562,15021,"Congressional District 3 (115th Congress), Arkansas",3,5,503,Congressional District 3,Arkansas,5001500US0503,772676,22452,-0.9709425425,-750224,0.02905745746
504,20,24815,37758,0.5215796897,12943,"Congressional District 4 (115th Congress), Arkansas",4,5,504,Congressional District 4,Arkansas,5001500US0504,715985,140505,-0.8037598553,-575480,0.1962401447
601,21,38370,46594,0.2143341152,8224,"Congressional District 1 (115th Congress), California",1,6,601,Congressional District 1,California,5001500US0601,703985,10053,-0.9857198662,-693932,0.01428013381
602,22,47315,65158,0.3771108528,17843,"Congressional District 2 (115th Congress), California",2,6,602,Congressional District 2,California,5001500US0602,713613,10745,-0.9849428191,-702868,0.01505718085
603,23,53797,57926,0.07675149172,4129,"Congressional District 3 (115th Congress), California",3,6,603,Congressional District 3,California,5001500US0603,722896,43299,-0.9401034174,-679597,0.05989658263
604,24,63086,69051,0.0945534667,5965,"Congressional District 4 (115th Congress), California",4,6,604,Congressional District 4,California,5001500US0604,718699,9472,-0.9868206301,-709227,0.01317936994
605,25,54059,67273,0.244436634,13214,"Congressional District 5 (115th Congress), California",5,6,605,Congressional District 5,California,5001500US0605,724966,46276,-0.936168041,-678690,0.06383195902
606,26,33804,49048,0.45095255,15244,"Congressional District 6 (115th Congress), California",6,6,606,Congressional District 6,California,5001500US0606,734450,91465,-0.8754646334,-642985,0.1245353666
607,27,51375,66846,0.3011386861,15471,"Congressional District 7 (115th Congress), California",7,6,607,Congressional District 7,California,5001500US0607,732954,54965,-0.9250089364,-677989,0.07499106356
608,28,31772,47171,0.4846720383,15399,"Congressional District 8 (115th Congress), California",8,6,608,Congressional District 8,California,5001500US0608,716168,58895,-0.9177637091,-657273,0.08223629093
609,29,41047,57832,0.4089214803,16785,"Congressional District 9 (115th Congress), California",9,6,609,Congressional District 9,California,5001500US0609,739025,65639,-0.9111816244,-673386,0.08881837556
610,30,47407,56256,0.1866601979,8849,"Congressional District 10 (115th Congress), California",10,6,610,Congressional District 10,California,5001500US0610,729022,23204,-0.9681710566,-705818,0.03182894343
611,31,47190,78487,0.663212545,31297,"Congressional District 11 (115th Congress), California",11,6,611,Congressional District 11,California,5001500US0611,739386,62209,-0.9158639736,-677177,0.08413602638
612,32,26423,88364,2.344207698,61941,"Congressional District 12 (115th Congress), California",12,6,612,Congressional District 12,California,5001500US0612,740337,40213,-0.9456828444,-700124,0.05431715557
613,33,38274,64948,0.6969221926,26674,"Congressional District 13 (115th Congress), California",13,6,613,Congressional District 13,California,5001500US0613,740683,131139,-0.8229485488,-609544,0.1770514512
614,34,54226,93666,0.7273263748,39440,"Congressional District 14 (115th Congress), California",14,6,614,Congressional District 14,California,5001500US0614,741332,22630,-0.969473866,-718702,0.03052613404
615,35,58799,97232,0.6536335652,38433,"Congressional District 15 (115th Congress), California",15,6,615,Congressional District 15,California,5001500US0615,751439,45912,-0.9389012282,-705527,0.06109877182
616,36,24006,38381,0.5988086312,14375,"Congressional District 16 (115th Congress), California",16,6,616,Congressional District 16,California,5001500US0616,721109,42971,-0.940409841,-678138,0.05959015905
617,37,69882,107946,0.5446896196,38064,"Congressional District 17 (115th Congress), California",17,6,617,Congressional District 17,California,5001500US0617,748800,19207,-0.9743496261,-729593,0.02565037393
618,38,68487,112702,0.6455969746,44215,"Congressional District 18 (115th Congress), California",18,6,618,Congressional District 18,California,5001500US0618,730782,13986,-0.9808615976,-716796,0.01913840242
619,39,63917,85010,0.3300061017,21093,"Congressional District 19 (115th Congress), California",19,6,619,Congressional District 19,California,5001500US0619,748954,22902,-0.969421353,-726052,0.03057864702
620,40,61606,62732,0.01827744051,1126,"Congressional District 20 (115th Congress), California",20,6,620,Congressional District 20,California,5001500US0620,729525,14241,-0.9804790789,-715284,0.01952092115
621,41,31914,38462,0.2051764116,6548,"Congressional District 21 (115th Congress), California",21,6,621,Congressional District 21,California,5001500US0621,711464,29486,-0.9585558791,-681978,0.04144412086
622,42,35334,53868,0.5245372729,18534,"Congressional District 22 (115th Congress), California",22,6,622,Congressional District 22,California,5001500US0622,739449,23239,-0.9685725452,-716210,0.03142745477
623,43,37532,56167,0.4965096451,18635,"Congressional District 23 (115th Congress), California",23,6,623,Congressional District 23,California,5001500US0623,730050,47269,-0.93525238,-682781,0.06474762003
624,44,54294,64676,0.1912181825,10382,"Congressional District 24 (115th Congress), California",24,6,624,Congressional District 24,California,5001500US0624,727935,14455,-0.9801424578,-713480,0.01985754223
625,45,42492,73819,0.7372446578,31327,"Congressional District 25 (115th Congress), California",25,6,625,Congressional District 25,California,5001500US0625,719970,56017,-0.9221953693,-663953,0.07780463075
626,46,68225,76719,0.1244998168,8494,"Congressional District 26 (115th Congress), California",26,6,626,Congressional District 26,California,5001500US0626,720336,13317,-0.981512794,-707019,0.01848720597
627,47,54015,70099,0.2977691382,16084,"Congressional District 27 (115th Congress), California",27,6,627,Congressional District 27,California,5001500US0627,717212,33040,-0.9539327284,-684172,0.0460672716
628,48,48709,58768,0.2065121435,10059,"Congressional District 28 (115th Congress), California",28,6,628,Congressional District 28,California,5001500US0628,716990,19872,-0.9722841323,-697118,0.02771586772
629,49,41909,48293,0.1523300484,6384,"Congressional District 29 (115th Congress), California",29,6,629,Congressional District 29,California,5001500US0629,717765,27812,-0.9612519418,-689953,0.03874805821
630,50,60942,72243,0.1854386138,11301,"Congressional District 30 (115th Congress), California",30,6,630,Congressional District 30,California,5001500US0630,750372,35670,-0.9524635781,-714702,0.04753642193
631,51,40917,55451,0.3552068822,14534,"Congressional District 31 (115th Congress), California",31,6,631,Congressional District 31,California,5001500US0631,733581,77946,-0.8937458849,-655635,0.1062541151
632,52,54679,61288,0.1208690722,6609,"Congressional District 32 (115th Congress), California",32,6,632,Congressional District 32,California,5001500US0632,719110,20624,-0.971320104,-698486,0.02867989598
633,53,71722,99902,0.3929059424,28180,"Congressional District 33 (115th Congress), California",33,6,633,Congressional District 33,California,5001500US0633,713625,20528,-0.9712341916,-693097,0.02876580837
634,54,24072,37136,0.5427052177,13064,"Congressional District 34 (115th Congress), California",34,6,634,Congressional District 34,California,5001500US0634,720384,31661,-0.956049829,-688723,0.04395017102
635,55,54387,55900,0.02781914796,1513,"Congressional District 35 (115th Congress), California",35,6,635,Congressional District 35,California,5001500US0635,730260,50009,-0.9315189111,-680251,0.06848108893
636,56,35300,45708,0.2948441926,10408,"Congressional District 36 (115th Congress), California",36,6,636,Congressional District 36,California,5001500US0636,736044,31532,-0.9571601698,-704512,0.04283983023
637,57,36179,51531,0.4243345587,15352,"Congressional District 37 (115th Congress), California",37,6,637,Congressional District 37,California,5001500US0637,722138,169733,-0.7649576674,-552405,0.2350423326
638,58,55556,63212,0.1378068975,7656,"Congressional District 38 (115th Congress), California",38,6,638,Congressional District 38,California,5001500US0638,717228,28530,-0.9602218541,-688698,0.03977814586
639,59,71760,80844,0.1265886288,9084,"Congressional District 39 (115th Congress), California",39,6,639,Congressional District 39,California,5001500US0639,722857,15931,-0.9779610628,-706926,0.02203893716
640,60,30603,41521,0.3567624089,10918,"Congressional District 40 (115th Congress), California",40,6,640,Congressional District 40,California,5001500US0640,709435,34706,-0.9510793801,-674729,0.04892061993
641,61,48736,56824,0.1659553513,8088,"Congressional District 41 (115th Congress), California",41,6,641,Congressional District 41,California,5001500US0641,739304,69152,-0.9064633764,-670152,0.09353662364
642,62,74446,73341,-0.01484297343,-1105,"Congressional District 42 (115th Congress), California",42,6,642,Congressional District 42,California,5001500US0642,761341,40769,-0.9464510646,-720572,0.05354893537
643,63,40542,50355,0.2420452864,9813,"Congressional District 43 (115th Congress), California",43,6,643,Congressional District 43,California,5001500US0643,719530,164990,-0.7706975387,-554540,0.2293024613
644,64,44770,47683,0.06506589234,2913,"Congressional District 44 (115th Congress), California",44,6,644,Congressional District 44,California,5001500US0644,721109,114539,-0.8411627091,-606570,0.1588372909
645,65,86993,93995,0.08048923477,7002,"Congressional District 45 (115th Congress), California",45,6,645,Congressional District 45,California,5001500US0645,749687,14313,-0.9809080323,-735374,0.01909196771
646,66,46347,56465,0.2183097072,10118,"Congressional District 46 (115th Congress), California",46,6,646,Congressional District 46,California,5001500US0646,726307,11811,-0.9837382815,-714496,0.01626171853
647,67,46941,60841,0.2961164014,13900,"Congressional District 47 (115th Congress), California",47,6,647,Congressional District 47,California,5001500US0647,716958,53116,-0.9259147677,-663842,0.07408523233
648,68,69250,83894,0.211465704,14644,"Congressional District 48 (115th Congress), California",48,6,648,Congressional District 48,California,5001500US0648,723983,8496,-0.9882649178,-715487,0.01173508218
649,69,61613,77558,0.2587927872,15945,"Congressional District 49 (115th Congress), California",49,6,649,Congressional District 49,California,5001500US0649,729768,19627,-0.9731051512,-710141,0.02689484877
650,70,57561,65656,0.140633415,8095,"Congressional District 50 (115th Congress), California",50,6,650,Congressional District 50,California,5001500US0650,736001,20671,-0.9719144403,-715330,0.02808555967
651,71,39594,42561,0.0749355963,2967,"Congressional District 51 (115th Congress), California",51,6,651,Congressional District 51,California,5001500US0651,730710,49044,-0.9328817178,-681666,0.06711828222
652,72,54945,86174,0.5683683684,31229,"Congressional District 52 (115th Congress), California",52,6,652,Congressional District 52,California,5001500US0652,742154,22613,-0.9695305826,-719541,0.0304694174
653,73,54088,65332,0.2078834492,11244,"Congressional District 53 (115th Congress), California",53,6,653,Congressional District 53,California,5001500US0653,753024,61894,-0.9178060726,-691130,0.08219392742
801,74,35519,58507,0.6472029055,22988,"Congressional District 1 (115th Congress), Colorado",1,8,801,Congressional District 1,Colorado,5001500US0801,786253,67170,-0.9145694834,-719083,0.08543051664
802,75,48776,72006,0.4762588158,23230,"Congressional District 2 (115th Congress), Colorado",2,8,802,Congressional District 2,Colorado,5001500US0802,771980,6833,-0.9911487344,-765147,0.008851265577
803,76,35897,49977,0.3922333343,14080,"Congressional District 3 (115th Congress), Colorado",3,8,803,Congressional District 3,Colorado,5001500US0803,727398,7407,-0.989817129,-719991,0.010182871
804,77,54293,67813,0.2490192106,13520,"Congressional District 4 (115th Congress), Colorado",4,8,804,Congressional District 4,Colorado,5001500US0804,764153,10764,-0.9859138157,-753389,0.01408618431
805,78,48232,58613,0.2152305523,10381,"Congressional District 5 (115th Congress), Colorado",5,8,805,Congressional District 5,Colorado,5001500US0805,761749,43579,-0.9427908668,-718170,0.05720913319
806,79,47758,72470,0.5174421039,24712,"Congressional District 6 (115th Congress), Colorado",6,8,806,Congressional District 6,Colorado,5001500US0806,779950,71675,-0.9081030835,-708275,0.09189691647
807,80,47001,62806,0.3362694411,15805,"Congressional District 7 (115th Congress), Colorado",7,8,807,Congressional District 7,Colorado,5001500US0807,767812,11921,-0.984474064,-755891,0.01552593604
901,81,45929,68058,0.4818088789,22129,"Congressional District 1 (115th Congress), Connecticut",1,9,901,Congressional District 1,Connecticut,5001500US0901,715145,108646,-0.8480783617,-606499,0.1519216383
902,82,47586,72760,0.5290211407,25174,"Congressional District 2 (115th Congress), Connecticut",2,9,902,Congressional District 2,Connecticut,5001500US0902,709761,27829,-0.9607910268,-681932,0.03920897316
903,83,39969,64333,0.6095724186,24364,"Congressional District 3 (115th Congress), Connecticut",3,9,903,Congressional District 3,Connecticut,5001500US0903,715345,97746,-0.8633582397,-617599,0.1366417603
904,84,45710,90142,0.9720411289,44432,"Congressional District 4 (115th Congress), Connecticut",4,9,904,Congressional District 4,Connecticut,5001500US0904,733754,91900,-0.874753664,-641854,0.125246336
905,85,42504,68984,0.6230001882,26480,"Congressional District 5 (115th Congress), Connecticut",5,9,905,Congressional District 5,Connecticut,5001500US0905,714565,46575,-0.9348204852,-667990,0.06517951481
1000,86,47450,61017,0.2859220232,13567,"Congressional District (at Large) (115th Congress), Delaware",0,10,1000,Congressional District (at Large),Delaware,5001500US1000,934695,203027,-0.7827879683,-731668,0.2172120317
1198,87,40560,72935,0.7982001972,32375,"Delegate District (at Large) (115th Congress), District of Columbia",98,11,1198,Delegate District (at Large),District of Columbia,5001500US1198,659009,318598,-0.5165498499,-340411,0.4834501501
1201,88,34813,51868,0.4899031971,17055,"Congressional District 1 (115th Congress), Florida",1,12,1201,Congressional District 1,Florida,5001500US1201,741949,98794,-0.8668452953,-643155,0.1331547047
1202,89,33148,45464,0.3715457946,12316,"Congressional District 2 (115th Congress), Florida",2,12,1202,Congressional District 2,Florida,5001500US1202,709130,91856,-0.8704666281,-617274,0.1295333719
1203,90,28646,45807,0.5990714236,17161,"Congressional District 3 (115th Congress), Florida",3,12,1203,Congressional District 3,Florida,5001500US1203,713474,115090,-0.8386906881,-598384,0.1613093119
1204,91,48965,63472,0.296272848,14507,"Congressional District 4 (115th Congress), Florida",4,12,1204,Congressional District 4,Florida,5001500US1204,747076,67590,-0.909527277,-679486,0.09047272299
1205,92,30721,37816,0.2309495134,7095,"Congressional District 5 (115th Congress), Florida",5,12,1205,Congressional District 5,Florida,5001500US1205,718313,339446,-0.5274399879,-378867,0.4725600121
1206,93,29753,44026,0.4797163311,14273,"Congressional District 6 (115th Congress), Florida",6,12,1206,Congressional District 6,Florida,5001500US1206,728594,75580,-0.8962659588,-653014,0.1037340412
1207,94,37497,54116,0.44320879,16619,"Congressional District 7 (115th Congress), Florida",7,12,1207,Congressional District 7,Florida,5001500US1207,737984,78877,-0.893118279,-659107,0.106881721
1208,95,33962,49297,0.4515340675,15335,"Congressional District 8 (115th Congress), Florida",8,12,1208,Congressional District 8,Florida,5001500US1208,720695,71883,-0.900258778,-648812,0.09974122201
1209,96,37209,45813,0.2312343788,8604,"Congressional District 9 (115th Congress), Florida",9,12,1209,Congressional District 9,Florida,5001500US1209,780261,103549,-0.8672892788,-676712,0.1327107212
1210,97,36058,48582,0.3473293028,12524,"Congressional District 10 (115th Congress), Florida",10,12,1210,Congressional District 10,Florida,5001500US1210,762103,213742,-0.7195365981,-548361,0.2804634019
1211,98,36295,43053,0.1861964458,6758,"Congressional District 11 (115th Congress), Florida",11,12,1211,Congressional District 11,Florida,5001500US1211,727833,52727,-0.9275561839,-675106,0.0724438161
1212,99,44691,48522,0.08572195744,3831,"Congressional District 12 (115th Congress), Florida",12,12,1212,Congressional District 12,Florida,5001500US1212,729430,33599,-0.9539380064,-695831,0.04606199361
1213,100,31259,45481,0.4549729678,14222,"Congressional District 13 (115th Congress), Florida",13,12,1213,Congressional District 13,Florida,5001500US1213,711119,88398,-0.8756916915,-622721,0.1243083085
1214,101,30192,48636,0.6108903021,18444,"Congressional District 14 (115th Congress), Florida",14,12,1214,Congressional District 14,Florida,5001500US1214,739946,136497,-0.8155311334,-603449,0.1844688666
1215,102,40764,51115,0.2539250319,10351,"Congressional District 15 (115th Congress), Florida",15,12,1215,Congressional District 15,Florida,5001500US1215,745465,107467,-0.855838973,-637998,0.144161027
1216,103,42435,53814,0.2681512902,11379,"Congressional District 16 (115th Congress), Florida",16,12,1216,Congressional District 16,Florida,5001500US1216,760542,64785,-0.9148173276,-695757,0.08518267236
1217,104,33125,44362,0.3392301887,11237,"Congressional District 17 (115th Congress), Florida",17,12,1217,Congressional District 17,Florida,5001500US1217,729130,56877,-0.9219933345,-672253,0.07800666548
1218,105,36595,53675,0.4667304277,17080,"Congressional District 18 (115th Congress), Florida",18,12,1218,Congressional District 18,Florida,5001500US1218,730787,92492,-0.8734350775,-638295,0.1265649225
1219,106,34453,53205,0.5442777117,18752,"Congressional District 19 (115th Congress), Florida",19,12,1219,Congressional District 19,Florida,5001500US1219,757388,58931,-0.922191796,-698457,0.07780820399
1220,107,38304,42440,0.107978279,4136,"Congressional District 20 (115th Congress), Florida",20,12,1220,Congressional District 20,Florida,5001500US1220,752660,402014,-0.4658756942,-350646,0.5341243058
1221,108,44134,53744,0.2177459555,9610,"Congressional District 21 (115th Congress), Florida",21,12,1221,Congressional District 21,Florida,5001500US1221,738761,114521,-0.8449823421,-624240,0.1550176579
1222,109,42218,57254,0.3561514046,15036,"Congressional District 22 (115th Congress), Florida",22,12,1222,Congressional District 22,Florida,5001500US1222,733500,109290,-0.851002045,-624210,0.148997955
1223,110,52266,60606,0.1595683618,8340,"Congressional District 23 (115th Congress), Florida",23,12,1223,Congressional District 23,Florida,5001500US1223,741077,102399,-0.861824075,-638678,0.138175925
1224,111,31848,36368,0.1419241397,4520,"Congressional District 24 (115th Congress), Florida",24,12,1224,Congressional District 24,Florida,5001500US1224,734086,371477,-0.4939598358,-362609,0.5060401642
1225,112,36417,44822,0.2307988028,8405,"Congressional District 25 (115th Congress), Florida",25,12,1225,Congressional District 25,Florida,5001500US1225,744163,36236,-0.951306367,-707927,0.04869363298
1226,113,38928,51148,0.3139128648,12220,"Congressional District 26 (115th Congress), Florida",26,12,1226,Congressional District 26,Florida,5001500US1226,761160,93394,-0.8773004362,-667766,0.1226995638
1227,114,37300,49953,0.3392225201,12653,"Congressional District 27 (115th Congress), Florida",27,12,1227,Congressional District 27,Florida,5001500US1227,737825,39483,-0.9464873107,-698342,0.05351268932
1301,115,34824,47573,0.3660980933,12749,"Congressional District 1 (115th Congress), Georgia",1,13,1301,Congressional District 1,Georgia,5001500US1301,723376,214188,-0.7039050231,-509188,0.2960949769
1302,116,25614,35183,0.3735847583,9569,"Congressional District 2 (115th Congress), Georgia",2,13,1302,Congressional District 2,Georgia,5001500US1302,685992,354016,-0.4839356727,-331976,0.5160643273
1303,117,37785,53655,0.4200079397,15870,"Congressional District 3 (115th Congress), Georgia",3,13,1303,Congressional District 3,Georgia,5001500US1303,714264,169780,-0.7623007739,-544484,0.2376992261
1304,118,47010,50048,0.06462454797,3038,"Congressional District 4 (115th Congress), Georgia",4,13,1304,Congressional District 4,Georgia,5001500US1304,730842,432222,-0.4085972071,-298620,0.5914027929
1305,119,33030,45882,0.3891008174,12852,"Congressional District 5 (115th Congress), Georgia",5,13,1305,Congressional District 5,Georgia,5001500US1305,736159,430934,-0.4146183094,-305225,0.5853816906
1306,120,50991,82390,0.6157753329,31399,"Congressional District 6 (115th Congress), Georgia",6,13,1306,Congressional District 6,Georgia,5001500US1306,731334,100417,-0.8626933795,-630917,0.1373066205
1307,121,53824,67534,0.2547190844,13710,"Congressional District 7 (115th Congress), Georgia",7,13,1307,Congressional District 7,Georgia,5001500US1307,761511,148583,-0.8048839741,-612928,0.1951160259
1308,122,28391,42013,0.4797999366,13622,"Congressional District 8 (115th Congress), Georgia",8,13,1308,Congressional District 8,Georgia,5001500US1308,703464,213571,-0.696400953,-489893,0.303599047
1309,123,26822,47477,0.7700768026,20655,"Congressional District 9 (115th Congress), Georgia",9,13,1309,Congressional District 9,Georgia,5001500US1309,716774,49633,-0.9307550218,-667141,0.06924497819
1310,124,31042,49040,0.5797951163,17998,"Congressional District 10 (115th Congress), Georgia",10,13,1310,Congressional District 10,Georgia,5001500US1310,720981,182502,-0.7468698898,-538479,0.2531301102
1311,125,50147,66258,0.3212754502,16111,"Congressional District 11 (115th Congress), Georgia",11,13,1311,Congressional District 11,Georgia,5001500US1311,735547,119488,-0.8375521891,-616059,0.1624478109
1312,126,29712,41442,0.3947899838,11730,"Congressional District 12 (115th Congress), Georgia",12,13,1312,Congressional District 12,Georgia,5001500US1312,709370,248279,-0.6500007049,-461091,0.3499992951
1313,127,51482,53136,0.03212773397,1654,"Congressional District 13 (115th Congress), Georgia",13,13,1313,Congressional District 13,Georgia,5001500US1313,729459,422523,-0.4207721065,-306936,0.5792278935
1314,128,38431,46248,0.2034035024,7817,"Congressional District 14 (115th Congress), Georgia",14,13,1314,Congressional District 14,Georgia,5001500US1314,700247,61998,-0.9114626696,-638249,0.0885373304
1501,129,72228,76200,0.05499252368,3972,"Congressional District 1 (115th Congress), Hawaii",1,15,1501,Congressional District 1,Hawaii,5001500US1501,707396,14769,-0.9791220193,-692627,0.02087798065
1502,130,56985,67716,0.1883127139,10731,"Congressional District 2 (115th Congress), Hawaii",2,15,1502,Congressional District 2,Hawaii,5001500US1502,706277,11102,-0.9842809549,-695175,0.01571904508
1601,131,60708,49892,-0.1781643276,-10816,"Congressional District 1 (115th Congress), Idaho",1,16,1601,Congressional District 1,Idaho,5001500US1601,833727,3768,-0.995480535,-829959,0.004519465005
1602,132,40537,48356,0.192885512,7819,"Congressional District 2 (115th Congress), Idaho",2,16,1602,Congressional District 2,Idaho,5001500US1602,801756,6665,-0.991686997,-795091,0.008313002959
1701,133,34868,49456,0.4183778823,14588,"Congressional District 1 (115th Congress), Illinois",1,17,1701,Congressional District 1,Illinois,5001500US1701,710088,364358,-0.4868833159,-345730,0.5131166841
1702,134,39309,45727,0.1632704979,6418,"Congressional District 2 (115th Congress), Illinois",2,17,1702,Congressional District 2,Illinois,5001500US1702,704139,396777,-0.4365075646,-307362,0.5634924354
1703,135,44862,63055,0.405532522,18193,"Congressional District 3 (115th Congress), Illinois",3,17,1703,Congressional District 3,Illinois,5001500US1703,722176,34522,-0.9521972483,-687654,0.04780275168
1704,136,36429,46557,0.2780202586,10128,"Congressional District 4 (115th Congress), Illinois",4,17,1704,Congressional District 4,Illinois,5001500US1704,702322,30716,-0.956265075,-671606,0.04373492501
1705,137,46149,74066,0.6049318512,27917,"Congressional District 5 (115th Congress), Illinois",5,17,1705,Congressional District 5,Illinois,5001500US1705,732035,20714,-0.9717035388,-711321,0.02829646123
1706,138,55064,93839,0.7041805899,38775,"Congressional District 6 (115th Congress), Illinois",6,17,1706,Congressional District 6,Illinois,5001500US1706,724601,19049,-0.9737110493,-705552,0.02628895075
1707,139,28844,51546,0.7870614339,22702,"Congressional District 7 (115th Congress), Illinois",7,17,1707,Congressional District 7,Illinois,5001500US1707,728896,360859,-0.5049238849,-368037,0.4950761151
1708,140,46057,66407,0.4418438022,20350,"Congressional District 8 (115th Congress), Illinois",8,17,1708,Congressional District 8,Illinois,5001500US1708,716964,33817,-0.9528330572,-683147,0.04716694283
1709,141,32376,65764,1.031257722,33388,"Congressional District 9 (115th Congress), Illinois",9,17,1709,Congressional District 9,Illinois,5001500US1709,718764,64402,-0.9103989627,-654362,0.08960103734
1710,142,39936,74233,0.8587990785,34297,"Congressional District 10 (115th Congress), Illinois",10,17,1710,Congressional District 10,Illinois,5001500US1710,713713,47856,-0.9329478376,-665857,0.06705216242
1711,143,49400,69355,0.4039473684,19955,"Congressional District 11 (115th Congress), Illinois",11,17,1711,Congressional District 11,Illinois,5001500US1711,722749,80084,-0.8891952808,-642665,0.1108047192
1712,144,25998,45874,0.7645203477,19876,"Congressional District 12 (115th Congress), Illinois",12,17,1712,Congressional District 12,Illinois,5001500US1712,703346,118022,-0.8321992305,-585324,0.1678007695
1713,145,27056,49031,0.812204317,21975,"Congressional District 13 (115th Congress), Illinois",13,17,1713,Congressional District 13,Illinois,5001500US1713,709735,80024,-0.8872480574,-629711,0.1127519426
1714,146,91209,86449,-0.05218783234,-4760,"Congressional District 14 (115th Congress), Illinois",14,17,1714,Congressional District 14,Illinois,5001500US1714,725478,23128,-0.9681203289,-702350,0.03187967106
1715,147,26357,49127,0.8639071214,22770,"Congressional District 15 (115th Congress), Illinois",15,17,1715,Congressional District 15,Illinois,5001500US1715,703108,30023,-0.9572995898,-673085,0.04270041018
1716,148,36456,56042,0.537250384,19586,"Congressional District 16 (115th Congress), Illinois",16,17,1716,Congressional District 16,Illinois,5001500US1716,700934,26665,-0.9619579019,-674269,0.03804209811
1717,149,25364,45144,0.7798454502,19780,"Congressional District 17 (115th Congress), Illinois",17,17,1717,Congressional District 17,Illinois,5001500US1717,698800,80044,-0.8854550658,-618756,0.1145449342
1718,150,33904,60947,0.7976344974,27043,"Congressional District 18 (115th Congress), Illinois",18,17,1718,Congressional District 18,Illinois,5001500US1718,713836,26552,-0.9628037813,-687284,0.03719621874
1801,151,32170,53183,0.6531861983,21013,"Congressional District 1 (115th Congress), Indiana",1,18,1801,Congressional District 1,Indiana,5001500US1801,717042,138010,-0.8075287082,-579032,0.1924712918
1802,152,24674,48073,0.9483261733,23399,"Congressional District 2 (115th Congress), Indiana",2,18,1802,Congressional District 2,Indiana,5001500US1802,721461,49550,-0.9313199189,-671911,0.06868008111
1803,153,26942,50277,0.8661198129,23335,"Congressional District 3 (115th Congress), Indiana",3,18,1803,Congressional District 3,Indiana,5001500US1803,733725,44199,-0.9397608096,-689526,0.06023919043
1804,154,37293,53333,0.4301075269,16040,"Congressional District 4 (115th Congress), Indiana",4,18,1804,Congressional District 4,Indiana,5001500US1804,741149,27743,-0.9625675809,-713406,0.03743241912
1805,155,41573,64754,0.5575974791,23181,"Congressional District 5 (115th Congress), Indiana",5,18,1805,Congressional District 5,Indiana,5001500US1805,749284,60603,-0.9191187854,-688681,0.0808812146
1806,156,31976,48554,0.5184513385,16578,"Congressional District 6 (115th Congress), Indiana",6,18,1806,Congressional District 6,Indiana,5001500US1806,719078,18061,-0.9748831142,-701017,0.02511688579
1807,157,29633,39917,0.3470455236,10284,"Congressional District 7 (115th Congress), Indiana",7,18,1807,Congressional District 7,Indiana,5001500US1807,747290,220637,-0.7047504985,-526653,0.2952495015
1808,158,25559,47444,0.856254157,21885,"Congressional District 8 (115th Congress), Indiana",8,18,1808,Congressional District 8,Indiana,5001500US1808,721951,28987,-0.9598490756,-692964,0.04015092437
1809,159,40631,51881,0.2768821836,11250,"Congressional District 9 (115th Congress), Indiana",9,18,1809,Congressional District 9,Indiana,5001500US1809,738598,20436,-0.9723313629,-718162,0.02766863707
1901,160,26432,55366,1.09465799,28934,"Congressional District 1 (115th Congress), Iowa",1,19,1901,Congressional District 1,Iowa,5001500US1901,769896,27355,-0.964469227,-742541,0.03553077299
1902,161,30417,52126,0.7137127264,21709,"Congressional District 2 (115th Congress), Iowa",2,19,1902,Congressional District 2,Iowa,5001500US1902,775699,31264,-0.9596957067,-744435,0.04030429329
1903,162,31997,60261,0.8833328125,28264,"Congressional District 3 (115th Congress), Iowa",3,19,1903,Congressional District 3,Iowa,5001500US1903,801132,32712,-0.9591677776,-768420,0.04083222241
1904,163,27454,51111,0.8616959277,23657,"Congressional District 4 (115th Congress), Iowa",4,19,1904,Congressional District 4,Iowa,5001500US1904,759862,11721,-0.9845748307,-748141,0.01542516931
2001,164,40285,48205,0.1965992305,7920,"Congressional District 1 (115th Congress), Kansas",1,20,2001,Congressional District 1,Kansas,5001500US2001,716382,21833,-0.9695232432,-694549,0.03047675681
2002,165,31544,50431,0.5987509511,18887,"Congressional District 2 (115th Congress), Kansas",2,20,2002,Congressional District 2,Kansas,5001500US2002,714490,31716,-0.9556102955,-682774,0.04438970454
2003,166,37450,68548,0.8303871829,31098,"Congressional District 3 (115th Congress), Kansas",3,20,2003,Congressional District 3,Kansas,5001500US2003,746158,64218,-0.9139351183,-681940,0.0860648817
2004,167,29276,51260,0.7509222571,21984,"Congressional District 4 (115th Congress), Kansas",4,20,2004,Congressional District 4,Kansas,5001500US2004,721262,49939,-0.9307616372,-671323,0.06923836276
2101,168,26381,39757,0.5070315758,13376,"Congressional District 1 (115th Congress), Kentucky",1,21,2101,Congressional District 1,Kentucky,5001500US2101,723571,50795,-0.9297995636,-672776,0.07020043645
2102,169,36271,47051,0.2972071352,10780,"Congressional District 2 (115th Congress), Kentucky",2,21,2102,Congressional District 2,Kentucky,5001500US2102,743449,40712,-0.9452390144,-702737,0.05476098562
2103,170,30361,49070,0.6162181746,18709,"Congressional District 3 (115th Congress), Kentucky",3,21,2103,Congressional District 3,Kentucky,5001500US2103,739212,158149,-0.7860573151,-581063,0.2139426849
2104,171,34644,57084,0.6477312089,22440,"Congressional District 4 (115th Congress), Kentucky",4,21,2104,Congressional District 4,Kentucky,5001500US2104,743503,24908,-0.9664991264,-718595,0.03350087357
2105,172,25437,31274,0.2294688839,5837,"Congressional District 5 (115th Congress), Kentucky",5,21,2105,Congressional District 5,Kentucky,5001500US2105,711115,10243,-0.98559586,-700872,0.01440413998
2106,173,30177,48170,0.5962487988,17993,"Congressional District 6 (115th Congress), Kentucky",6,21,2106,Congressional District 6,Kentucky,5001500US2106,751139,65435,-0.912885631,-685704,0.08711436898
2201,174,33315,55997,0.680834459,22682,"Congressional District 1 (115th Congress), Louisiana",1,22,2201,Congressional District 1,Louisiana,5001500US2201,792297,105721,-0.8665639274,-686576,0.1334360726
2202,175,28486,37096,0.3022537387,8610,"Congressional District 2 (115th Congress), Louisiana",2,22,2202,Congressional District 2,Louisiana,5001500US2202,779918,485145,-0.3779538362,-294773,0.6220461638
2203,176,28287,47016,0.6621062679,18729,"Congressional District 3 (115th Congress), Louisiana",3,22,2203,Congressional District 3,Louisiana,5001500US2203,775987,189645,-0.7556080192,-586342,0.2443919808
2204,177,25759,41240,0.6009938274,15481,"Congressional District 4 (115th Congress), Louisiana",4,22,2204,Congressional District 4,Louisiana,5001500US2204,759843,258522,-0.6597691892,-501321,0.3402308108
2205,178,21698,35968,0.6576643009,14270,"Congressional District 5 (115th Congress), Louisiana",5,22,2205,Congressional District 5,Louisiana,5001500US2205,752483,267023,-0.6451441428,-485460,0.3548558572
2206,179,41643,58628,0.4078716711,16985,"Congressional District 6 (115th Congress), Louisiana",6,22,2206,Congressional District 6,Louisiana,5001500US2206,785142,188145,-0.7603681882,-596997,0.2396318118
2301,180,27886,57209,1.051531234,29323,"Congressional District 1 (115th Congress), Maine",1,23,2301,Congressional District 1,Maine,5001500US2301,673137,11046,-0.9835902647,-662091,0.01640973531
2302,181,27478,44649,0.6248999199,17171,"Congressional District 2 (115th Congress), Maine",2,23,2302,Congressional District 2,Maine,5001500US2302,656786,5257,-0.9919958708,-651529,0.008004129199
2401,182,39564,69650,0.7604387827,30086,"Congressional District 1 (115th Congress), Maryland",1,24,2401,Congressional District 1,Maryland,5001500US2401,728394,86613,-0.8810904538,-641781,0.1189095462
2402,183,57206,63876,0.1165961612,6670,"Congressional District 2 (115th Congress), Maryland",2,24,2402,Congressional District 2,Maryland,5001500US2402,751657,253802,-0.6623433295,-497855,0.3376566705
2403,184,61206,81032,0.3239224913,19826,"Congressional District 3 (115th Congress), Maryland",3,24,2403,Congressional District 3,Maryland,5001500US2403,747023,162725,-0.7821686882,-584298,0.2178313118
2404,185,69992,76776,0.0969253629,6784,"Congressional District 4 (115th Congress), Maryland",4,24,2404,Congressional District 4,Maryland,5001500US2404,741905,392546,-0.4708945215,-349359,0.5291054785
2405,186,89489,92295,0.03135580909,2806,"Congressional District 5 (115th Congress), Maryland",5,24,2405,Congressional District 5,Maryland,5001500US2405,753865,286180,-0.6203829598,-467685,0.3796170402
2406,187,62682,74892,0.1947927635,12210,"Congressional District 6 (115th Congress), Maryland",6,24,2406,Congressional District 6,Maryland,5001500US2406,755153,101731,-0.8652842537,-653422,0.1347157463
2407,188,40866,58128,0.4224049332,17262,"Congressional District 7 (115th Congress), Maryland",7,24,2407,Congressional District 7,Maryland,5001500US2407,727420,391364,-0.4619834484,-336056,0.5380165516
2408,189,66896,97663,0.4599228653,30767,"Congressional District 8 (115th Congress), Maryland",8,24,2408,Congressional District 8,Maryland,5001500US2408,754485,90965,-0.8794343161,-663520,0.1205656839
2501,190,36622,53667,0.4654306155,17045,"Congressional District 1 (115th Congress), Massachusetts",1,25,2501,Congressional District 1,Massachusetts,5001500US2501,730824,45701,-0.9374664762,-685123,0.0625335238
2502,191,42039,64341,0.530507386,22302,"Congressional District 2 (115th Congress), Massachusetts",2,25,2502,Congressional District 2,Massachusetts,5001500US2502,740590,37837,-0.9489096531,-702753,0.05109034689
2503,192,49243,72039,0.4629287411,22796,"Congressional District 3 (115th Congress), Massachusetts",3,25,2503,Congressional District 3,Massachusetts,5001500US2503,754800,28049,-0.9628391627,-726751,0.03716083731
2504,193,63695,91203,0.4318706335,27508,"Congressional District 4 (115th Congress), Massachusetts",4,25,2504,Congressional District 4,Massachusetts,5001500US2504,747492,21596,-0.9711087209,-725896,0.0288912791
2505,194,58022,86416,0.4893661025,28394,"Congressional District 5 (115th Congress), Massachusetts",5,25,2505,Congressional District 5,Massachusetts,5001500US2505,753460,37294,-0.9505030128,-716166,0.04949698723
2506,195,51420,81711,0.5890898483,30291,"Congressional District 6 (115th Congress), Massachusetts",6,25,2506,Congressional District 6,Massachusetts,5001500US2506,755438,25191,-0.9666537823,-730247,0.03334621769
2507,196,40953,55508,0.3554074183,14555,"Congressional District 7 (115th Congress), Massachusetts",7,25,2507,Congressional District 7,Massachusetts,5001500US2507,768049,199757,-0.7399163335,-568292,0.2600836665
2508,197,51867,78995,0.5230300576,27128,"Congressional District 8 (115th Congress), Massachusetts",8,25,2508,Congressional District 8,Massachusetts,5001500US2508,756875,73481,-0.9029152766,-683394,0.09708472337
2509,198,37210,64092,0.7224402042,26882,"Congressional District 9 (115th Congress), Massachusetts",9,25,2509,Congressional District 9,Massachusetts,5001500US2509,734615,20327,-0.9723297237,-714288,0.02767027627
2601,199,31761,44864,0.4125499827,13103,"Congressional District 1 (115th Congress), Michigan",1,26,2601,Congressional District 1,Michigan,5001500US2601,702602,11353,-0.9838414921,-691249,0.01615850795
2602,200,26968,50916,0.8880154257,23948,"Congressional District 2 (115th Congress), Michigan",2,26,2602,Congressional District 2,Michigan,5001500US2602,724022,45343,-0.93737345,-678679,0.06262655002
2603,201,28089,53680,0.9110683898,25591,"Congressional District 3 (115th Congress), Michigan",3,26,2603,Congressional District 3,Michigan,5001500US2603,725581,62345,-0.9140757545,-663236,0.08592424554
2604,202,30257,46128,0.5245397759,15871,"Congressional District 4 (115th Congress), Michigan",4,26,2604,Congressional District 4,Michigan,5001500US2604,701884,12534,-0.9821423483,-689350,0.01785765169
2605,203,25474,42100,0.6526654628,16626,"Congressional District 5 (115th Congress), Michigan",5,26,2605,Congressional District 5,Michigan,5001500US2605,687000,119506,-0.8260465793,-567494,0.1739534207
2606,204,25951,49087,0.8915263381,23136,"Congressional District 6 (115th Congress), Michigan",6,26,2606,Congressional District 6,Michigan,5001500US2606,712805,59232,-0.9169029398,-653573,0.08309706021
2607,205,32098,54225,0.6893575924,22127,"Congressional District 7 (115th Congress), Michigan",7,26,2607,Congressional District 7,Michigan,5001500US2607,704160,30228,-0.9570722563,-673932,0.04292774369
2608,206,35428,65205,0.8404933951,29777,"Congressional District 8 (115th Congress), Michigan",8,26,2608,Congressional District 8,Michigan,5001500US2608,723429,39678,-0.9451528761,-683751,0.05484712391
2609,207,35004,52684,0.5050851331,17680,"Congressional District 9 (115th Congress), Michigan",9,26,2609,Congressional District 9,Michigan,5001500US2609,715955,89331,-0.8752281917,-626624,0.1247718083
2610,208,55000,58557,0.06467272727,3557,"Congressional District 10 (115th Congress), Michigan",10,26,2610,Congressional District 10,Michigan,5001500US2610,711809,20132,-0.971717132,-691677,0.02828286802
2611,209,53670,76851,0.4319172722,23181,"Congressional District 11 (115th Congress), Michigan",11,26,2611,Congressional District 11,Michigan,5001500US2611,717277,37160,-0.9481929575,-680117,0.05180704247
2612,210,36343,53815,0.4807528272,17472,"Congressional District 12 (115th Congress), Michigan",12,26,2612,Congressional District 12,Michigan,5001500US2612,705980,75378,-0.89322927,-630602,0.10677073
2613,211,25590,32076,0.2534583822,6486,"Congressional District 13 (115th Congress), Michigan",13,26,2613,Congressional District 13,Michigan,5001500US2613,684837,380465,-0.4444444444,-304372,0.5555555556
2614,212,33543,42167,0.2571028232,8624,"Congressional District 14 (115th Congress), Michigan",14,26,2614,Congressional District 14,Michigan,5001500US2614,692259,393761,-0.4311941051,-298498,0.5688058949
2701,213,26215,57780,1.204081633,31565,"Congressional District 1 (115th Congress), Minnesota",1,27,2701,Congressional District 1,Minnesota,5001500US2701,668498,19015,-0.9715556367,-649483,0.02844436333
2702,214,49333,77468,0.5703079075,28135,"Congressional District 2 (115th Congress), Minnesota",2,27,2702,Congressional District 2,Minnesota,5001500US2702,686967,28747,-0.9581537396,-658220,0.04184626045
2703,215,40544,81804,1.017659826,41260,"Congressional District 3 (115th Congress), Minnesota",3,27,2703,Congressional District 3,Minnesota,5001500US2703,695383,48810,-0.9298084653,-646573,0.07019153474
2704,216,30750,63826,1.075642276,33076,"Congressional District 4 (115th Congress), Minnesota",4,27,2704,Congressional District 4,Minnesota,5001500US2704,693301,67272,-0.9029685519,-626029,0.0970314481
2705,217,24966,55396,1.218857646,30430,"Congressional District 5 (115th Congress), Minnesota",5,27,2705,Congressional District 5,Minnesota,5001500US2705,693188,115043,-0.8340378079,-578145,0.1659621921
2706,218,34250,73884,1.15719708,39634,"Congressional District 6 (115th Congress), Minnesota",6,27,2706,Congressional District 6,Minnesota,5001500US2706,687421,17753,-0.974174487,-669668,0.02582551304
2707,219,20274,52930,1.610732958,32656,"Congressional District 7 (115th Congress), Minnesota",7,27,2707,Congressional District 7,Minnesota,5001500US2707,663338,7332,-0.9889468114,-656006,0.01105318857
2708,220,19398,51684,1.664398392,32286,"Congressional District 8 (115th Congress), Minnesota",8,27,2708,Congressional District 8,Minnesota,5001500US2708,662772,6881,-0.9896178475,-655891,0.01038215254
2801,221,30235,42647,0.410517612,12412,"Congressional District 1 (115th Congress), Mississippi",1,28,2801,Congressional District 1,Mississippi,5001500US2801,755945,205742,-0.727834697,-550203,0.272165303
2802,222,25859,32409,0.2532967245,6550,"Congressional District 2 (115th Congress), Mississippi",2,28,2802,Congressional District 2,Mississippi,5001500US2802,723747,474859,-0.3438881267,-248888,0.6561118733
2803,223,27971,42767,0.5289764399,14796,"Congressional District 3 (115th Congress), Mississippi",3,28,2803,Congressional District 3,Mississippi,5001500US2803,748787,262921,-0.6488707737,-485866,0.3511292263
2804,224,26613,43173,0.6222522827,16560,"Congressional District 4 (115th Congress), Mississippi",4,28,2804,Congressional District 4,Mississippi,5001500US2804,760713,177805,-0.7662653327,-582908,0.2337346673
2901,225,32105,41817,0.3025073976,9712,"Congressional District 1 (115th Congress), Missouri",1,29,2901,Congressional District 1,Missouri,5001500US2901,740262,365921,-0.5056871756,-374341,0.4943128244
2902,226,54353,76996,0.4165915405,22643,"Congressional District 2 (115th Congress), Missouri",2,29,2902,Congressional District 2,Missouri,5001500US2902,760782,28455,-0.9625976955,-732327,0.03740230447
2903,227,37157,57658,0.5517399144,20501,"Congressional District 3 (115th Congress), Missouri",3,29,2903,Congressional District 3,Missouri,5001500US2903,768153,25244,-0.9671367553,-742909,0.03286324469
2904,228,34959,45929,0.3137961612,10970,"Congressional District 4 (115th Congress), Missouri",4,29,2904,Congressional District 4,Missouri,5001500US2904,761184,35105,-0.953881059,-726079,0.04611894102
2905,229,32355,45886,0.4182042961,13531,"Congressional District 5 (115th Congress), Missouri",5,29,2905,Congressional District 5,Missouri,5001500US2905,757531,166637,-0.7800261639,-590894,0.2199738361
2906,230,42854,55377,0.2922247631,12523,"Congressional District 6 (115th Congress), Missouri",6,29,2906,Congressional District 6,Missouri,5001500US2906,760050,31400,-0.9586869285,-728650,0.04131307151
2907,231,30033,42719,0.4224020244,12686,"Congressional District 7 (115th Congress), Missouri",7,29,2907,Congressional District 7,Missouri,5001500US2907,764936,14423,-0.9811448278,-750513,0.0188551722
2908,232,22467,39076,0.7392620288,16609,"Congressional District 8 (115th Congress), Missouri",8,29,2908,Congressional District 8,Missouri,5001500US2908,746753,34711,-0.9535174281,-712042,0.04648257188
3000,233,28863,48380,0.6761944358,19517,"Congressional District (at Large) (115th Congress), Montana",0,30,3000,Congressional District (at Large),Montana,5001500US3000,1023391,4260,-0.9958373681,-1019131,0.004162631878
3101,234,36378,55048,0.5132222772,18670,"Congressional District 1 (115th Congress), Nebraska",1,31,3101,Congressional District 1,Nebraska,5001500US3101,630685,18278,-0.9710188129,-612407,0.02898118712
3102,235,28758,59906,1.083107309,31148,"Congressional District 2 (115th Congress), Nebraska",2,31,3102,Congressional District 2,Nebraska,5001500US3102,643888,63081,-0.9020310986,-580807,0.09796890142
3103,236,29389,50034,0.7024737147,20645,"Congressional District 3 (115th Congress), Nebraska",3,31,3103,Congressional District 3,Nebraska,5001500US3103,606686,7029,-0.9884141055,-599657,0.01158589452
3201,237,27208,38941,0.4312334607,11733,"Congressional District 1 (115th Congress), Nevada",1,32,3201,Congressional District 1,Nevada,5001500US3201,685133,75178,-0.8902723997,-609955,0.1097276003
3202,238,37592,55692,0.4814854224,18100,"Congressional District 2 (115th Congress), Nevada",2,32,3202,Congressional District 2,Nevada,5001500US3202,696099,13097,-0.9811851475,-683002,0.01881485249
3203,239,50313,64740,0.2867449764,14427,"Congressional District 3 (115th Congress), Nevada",3,32,3203,Congressional District 3,Nevada,5001500US3203,739847,51716,-0.930099061,-688131,0.06990093898
3204,240,43217,53889,0.2469398616,10672,"Congressional District 4 (115th Congress), Nevada",4,32,3204,Congressional District 4,Nevada,5001500US3204,718093,103561,-0.8557833038,-614532,0.1442166962
3301,241,48173,69225,0.4370082826,21052,"Congressional District 1 (115th Congress), New Hampshire",1,33,3301,Congressional District 1,New Hampshire,5001500US3301,667330,9752,-0.9853865404,-657578,0.01461345961
3302,242,53536,67675,0.2641026599,14139,"Congressional District 2 (115th Congress), New Hampshire",2,33,3302,Congressional District 2,New Hampshire,5001500US3302,660173,7731,-0.9882894332,-652442,0.01171056678
3401,243,45208,65770,0.4548310034,20562,"Congressional District 1 (115th Congress), New Jersey",1,34,3401,Congressional District 1,New Jersey,5001500US3401,731077,127173,-0.8260470511,-603904,0.1739529489
3402,244,35219,59785,0.6975212243,24566,"Congressional District 2 (115th Congress), New Jersey",2,34,3402,Congressional District 2,New Jersey,5001500US3402,729824,93000,-0.8725720174,-636824,0.1274279826
3403,245,67452,74644,0.1066239696,7192,"Congressional District 3 (115th Congress), New Jersey",3,34,3403,Congressional District 3,New Jersey,5001500US3403,736722,78318,-0.8936939578,-658404,0.1063060422
3404,246,52337,77685,0.4843227545,25348,"Congressional District 4 (115th Congress), New Jersey",4,34,3404,Congressional District 4,New Jersey,5001500US3404,738951,48596,-0.9342365055,-690355,0.06576349447
3405,247,65535,95701,0.4603036545,30166,"Congressional District 5 (115th Congress), New Jersey",5,34,3405,Congressional District 5,New Jersey,5001500US3405,742080,38376,-0.9482858991,-703704,0.05171410091
3406,248,58825,77157,0.3116362091,18332,"Congressional District 6 (115th Congress), New Jersey",6,34,3406,Congressional District 6,New Jersey,5001500US3406,743100,75479,-0.8984268604,-667621,0.1015731396
3407,249,75110,104987,0.3977765943,29877,"Congressional District 7 (115th Congress), New Jersey",7,34,3407,Congressional District 7,New Jersey,5001500US3407,741497,33950,-0.954214245,-707547,0.04578575503
3408,250,41256,55493,0.3450891991,14237,"Congressional District 8 (115th Congress), New Jersey",8,34,3408,Congressional District 8,New Jersey,5001500US3408,766386,80692,-0.8947110203,-685694,0.1052889797
3409,251,42155,62559,0.4840232475,20404,"Congressional District 9 (115th Congress), New Jersey",9,34,3409,Congressional District 9,New Jersey,5001500US3409,751662,80773,-0.8925407963,-670889,0.1074592037
3410,252,40306,48168,0.1950578078,7862,"Congressional District 10 (115th Congress), New Jersey",10,34,3410,Congressional District 10,New Jersey,5001500US3410,741960,391212,-0.4727316836,-350748,0.5272683164
3411,253,81070,103419,0.2756753423,22349,"Congressional District 11 (115th Congress), New Jersey",11,34,3411,Congressional District 11,New Jersey,5001500US3411,740727,27655,-0.9626650574,-713072,0.03733494256
3412,254,53182,81115,0.5252341018,27933,"Congressional District 12 (115th Congress), New Jersey",12,34,3412,Congressional District 12,New Jersey,5001500US3412,751470,131997,-0.8243482774,-619473,0.1756517226
3501,255,39658,47990,0.2100963236,8332,"Congressional District 1 (115th Congress), New Mexico",1,35,3501,Congressional District 1,New Mexico,5001500US3501,692610,19068,-0.972469355,-673542,0.02753064495
3502,256,42209,41600,-0.01442820252,-609,"Congressional District 2 (115th Congress), New Mexico",2,35,3502,Congressional District 2,New Mexico,5001500US3502,698524,12239,-0.9824787695,-686285,0.01752123048
3503,257,43735,47956,0.0965130902,4221,"Congressional District 3 (115th Congress), New Mexico",3,35,3503,Congressional District 3,New Mexico,5001500US3503,691535,10650,-0.984599478,-680885,0.01540052203
3601,258,50820,88242,0.7363636364,37422,"Congressional District 1 (115th Congress), New York",1,36,3601,Congressional District 1,New York,5001500US3601,722038,36208,-0.9498530548,-685830,0.05014694517
3602,259,75895,90614,0.1939389947,14719,"Congressional District 2 (115th Congress), New York",2,36,3602,Congressional District 2,New York,5001500US3602,720950,72296,-0.8997212012,-648654,0.1002787988
3603,260,80111,104805,0.3082473069,24694,"Congressional District 3 (115th Congress), New York",3,36,3603,Congressional District 3,New York,5001500US3603,724563,22430,-0.9690434096,-702133,0.03095659039
3604,261,81304,96078,0.1817130768,14774,"Congressional District 4 (115th Congress), New York",4,36,3604,Congressional District 4,New York,5001500US3604,722016,104994,-0.8545821699,-617022,0.1454178301
3605,262,65603,62979,-0.03999817082,-2624,"Congressional District 5 (115th Congress), New York",5,36,3605,Congressional District 5,New York,5001500US3605,774752,383533,-0.504960297,-391219,0.495039703
3606,263,61696,60158,-0.02492868257,-1538,"Congressional District 6 (115th Congress), New York",6,36,3606,Congressional District 6,New York,5001500US3606,730534,28787,-0.9605945788,-701747,0.03940542124
3607,264,34857,49581,0.4224115673,14724,"Congressional District 7 (115th Congress), New York",7,36,3607,Congressional District 7,New York,5001500US3607,748294,83754,-0.8880734043,-664540,0.1119265957
3608,265,43735,47048,0.07575168629,3313,"Congressional District 8 (115th Congress), New York",8,36,3608,Congressional District 8,New York,5001500US3608,753062,414064,-0.4501594822,-338998,0.5498405178
3609,266,41691,50825,0.2190880526,9134,"Congressional District 9 (115th Congress), New York",9,36,3609,Congressional District 9,New York,5001500US3609,742131,374714,-0.4950837521,-367417,0.5049162479
3610,267,44487,81814,0.8390541057,37327,"Congressional District 10 (115th Congress), New York",10,36,3610,Congressional District 10,New York,5001500US3610,731073,29362,-0.9598371161,-701711,0.04016288387
3611,268,45158,66890,0.4812436335,21732,"Congressional District 11 (115th Congress), New York",11,36,3611,Congressional District 11,New York,5001500US3611,729159,55017,-0.924547321,-674142,0.07545267905
3612,269,37569,93559,1.49032447,55990,"Congressional District 12 (115th Congress), New York",12,36,3612,Congressional District 12,New York,5001500US3612,725977,36066,-0.9503207402,-689911,0.04967925981
3613,270,33591,37263,0.1093149951,3672,"Congressional District 13 (115th Congress), New York",13,36,3613,Congressional District 13,New York,5001500US3613,768090,230237,-0.7002473668,-537853,0.2997526332
3614,271,52201,52427,0.004329418977,226,"Congressional District 14 (115th Congress), New York",14,36,3614,Congressional District 14,New York,5001500US3614,722309,79510,-0.889922457,-642799,0.110077543
3615,272,29579,26096,-0.1177524595,-3483,"Congressional District 15 (115th Congress), New York",15,36,3615,Congressional District 15,New York,5001500US3615,747882,242173,-0.6761882222,-505709,0.3238117778
3616,273,52043,66153,0.2711219568,14110,"Congressional District 16 (115th Congress), New York",16,36,3616,Congressional District 16,New York,5001500US3616,738787,241558,-0.6730343116,-497229,0.3269656884
3617,274,69029,91734,0.3289197294,22705,"Congressional District 17 (115th Congress), New York",17,36,3617,Congressional District 17,New York,5001500US3617,738467,79026,-0.8929864165,-659441,0.1070135835
3618,275,55307,79539,0.4381362215,24232,"Congressional District 18 (115th Congress), New York",18,36,3618,Congressional District 18,New York,5001500US3618,721184,68153,-0.9054984581,-653031,0.09450154191
3619,276,37919,58698,0.5479838603,20779,"Congressional District 19 (115th Congress), New York",19,36,3619,Congressional District 19,New York,5001500US3619,707053,31501,-0.95544747,-675552,0.04455253001
3620,277,31317,62112,0.9833317368,30795,"Congressional District 20 (115th Congress), New York",20,36,3620,Congressional District 20,New York,5001500US3620,725336,66653,-0.908107415,-658683,0.09189258495
3621,278,46743,51976,0.1119525918,5233,"Congressional District 21 (115th Congress), New York",21,36,3621,Congressional District 21,New York,5001500US3621,715390,22230,-0.9689260403,-693160,0.03107395966
3622,279,25678,50059,0.9494898357,24381,"Congressional District 22 (115th Congress), New York",22,36,3622,Congressional District 22,New York,5001500US3622,708362,28821,-0.959313176,-679541,0.04068682397
3623,280,25213,47916,0.9004481815,22703,"Congressional District 23 (115th Congress), New York",23,36,3623,Congressional District 23,New York,5001500US3623,709936,20651,-0.9709114624,-689285,0.02908853756
3624,281,28741,53930,0.876413486,25189,"Congressional District 24 (115th Congress), New York",24,36,3624,Congressional District 24,New York,5001500US3624,713917,59259,-0.9169945526,-654658,0.08300544741
3625,282,28487,53060,0.8626039948,24573,"Congressional District 25 (115th Congress), New York",25,36,3625,Congressional District 25,New York,5001500US3625,722212,113898,-0.8422928448,-608314,0.1577071552
3626,283,26503,45640,0.7220691997,19137,"Congressional District 26 (115th Congress), New York",26,36,3626,Congressional District 26,New York,5001500US3626,714792,130194,-0.8178575026,-584598,0.1821424974
3627,284,35371,61359,0.7347261881,25988,"Congressional District 27 (115th Congress), New York",27,36,3627,Congressional District 27,New York,5001500US3627,719191,18189,-0.9747090828,-701002,0.02529091716
3701,285,30454,40587,0.3327313325,10133,"Congressional District 1 (115th Congress), North Carolina",1,37,3701,Congressional District 1,North Carolina,5001500US3701,745646,333783,-0.5523572848,-411863,0.4476427152
3702,286,40521,61538,0.518669332,21017,"Congressional District 2 (115th Congress), North Carolina",2,37,3702,Congressional District 2,North Carolina,5001500US3702,791508,155502,-0.8035370457,-636006,0.1964629543
3703,287,31930,46916,0.4693391795,14986,"Congressional District 3 (115th Congress), North Carolina",3,37,3703,Congressional District 3,North Carolina,5001500US3703,749072,155066,-0.792989192,-594006,0.207010808
3704,288,44700,64252,0.4374049217,19552,"Congressional District 4 (115th Congress), North Carolina",4,37,3704,Congressional District 4,North Carolina,5001500US3704,806437,181504,-0.7749309617,-624933,0.2250690383
3705,289,30749,42087,0.3687274383,11338,"Congressional District 5 (115th Congress), North Carolina",5,37,3705,Congressional District 5,North Carolina,5001500US3705,745704,108229,-0.8548633238,-637475,0.1451366762
3706,290,32523,45391,0.3956584571,12868,"Congressional District 6 (115th Congress), North Carolina",6,37,3706,Congressional District 6,North Carolina,5001500US3706,754902,150812,-0.8002230753,-604090,0.1997769247
3707,291,27615,44413,0.6082925946,16798,"Congressional District 7 (115th Congress), North Carolina",7,37,3707,Congressional District 7,North Carolina,5001500US3707,768409,150115,-0.8046417988,-618294,0.1953582012
3708,292,37074,48643,0.3120515725,11569,"Congressional District 8 (115th Congress), North Carolina",8,37,3708,Congressional District 8,North Carolina,5001500US3708,760680,172502,-0.7732265867,-588178,0.2267734133
3709,293,31104,53630,0.724215535,22526,"Congressional District 9 (115th Congress), North Carolina",9,37,3709,Congressional District 9,North Carolina,5001500US3709,763890,149222,-0.8046551205,-614668,0.1953448795
3710,294,28448,43877,0.5423579865,15429,"Congressional District 10 (115th Congress), North Carolina",10,37,3710,Congressional District 10,North Carolina,5001500US3710,743721,89368,-0.8798366592,-654353,0.1201633408
3711,295,27188,41913,0.541599235,14725,"Congressional District 11 (115th Congress), North Carolina",11,37,3711,Congressional District 11,North Carolina,5001500US3711,743349,24326,-0.9672751292,-719023,0.03272487082
3712,296,40044,53409,0.3337578663,13365,"Congressional District 12 (115th Congress), North Carolina",12,37,3712,Congressional District 12,North Carolina,5001500US3712,811813,300673,-0.6296277591,-511140,0.3703722409
3713,297,32107,46792,0.457376896,14685,"Congressional District 13 (115th Congress), North Carolina",13,37,3713,Congressional District 13,North Carolina,5001500US3713,755697,166029,-0.780296865,-589668,0.219703135
3800,298,28474,59114,1.076069397,30640,"Congressional District (at Large) (115th Congress), North Dakota",0,38,3800,Congressional District (at Large),North Dakota,5001500US3800,736162,14761,-0.9799487069,-721401,0.02005129306
3901,299,25402,53393,1.101921109,27991,"Congressional District 1 (115th Congress), Ohio",1,39,3901,Congressional District 1,Ohio,5001500US3901,730363,160385,-0.7804037171,-569978,0.2195962829
3902,300,32755,52629,0.6067470615,19874,"Congressional District 2 (115th Congress), Ohio",2,39,3902,Congressional District 2,Ohio,5001500US3902,724850,61843,-0.9146816583,-663007,0.08531834173
3903,301,32679,42960,0.3146057101,10281,"Congressional District 3 (115th Congress), Ohio",3,39,3903,Congressional District 3,Ohio,5001500US3903,757872,248344,-0.6723140583,-509528,0.3276859417
3904,302,26030,49974,0.919861698,23944,"Congressional District 4 (115th Congress), Ohio",4,39,3904,Congressional District 4,Ohio,5001500US3904,712613,37216,-0.9477753002,-675397,0.0522246998
3905,303,36934,54480,0.475063627,17546,"Congressional District 5 (115th Congress), Ohio",5,39,3905,Congressional District 5,Ohio,5001500US3905,724865,20999,-0.9710304677,-703866,0.02896953226
3906,304,24676,44574,0.8063705625,19898,"Congressional District 6 (115th Congress), Ohio",6,39,3906,Congressional District 6,Ohio,5001500US3906,707254,15894,-0.9775271685,-691360,0.02247283154
3907,305,27299,50830,0.861972966,23531,"Congressional District 7 (115th Congress), Ohio",7,39,3907,Congressional District 7,Ohio,5001500US3907,723913,29170,-0.9597051027,-694743,0.04029489732
3908,306,34732,53561,0.5421225383,18829,"Congressional District 8 (115th Congress), Ohio",8,39,3908,Congressional District 8,Ohio,5001500US3908,724240,43179,-0.9403802607,-681061,0.05961973931
3909,307,24063,41179,0.7112995055,17116,"Congressional District 9 (115th Congress), Ohio",9,39,3909,Congressional District 9,Ohio,5001500US3909,712630,114939,-0.8387115333,-597691,0.1612884667
3910,308,29804,48257,0.6191450812,18453,"Congressional District 10 (115th Congress), Ohio",10,39,3910,Congressional District 10,Ohio,5001500US3910,721070,122276,-0.8304242307,-598794,0.1695757693
3911,309,26045,34673,0.3312727971,8628,"Congressional District 11 (115th Congress), Ohio",11,39,3911,Congressional District 11,Ohio,5001500US3911,700217,374795,-0.4647445006,-325422,0.5352554994
3912,310,49415,66774,0.3512900941,17359,"Congressional District 12 (115th Congress), Ohio",12,39,3912,Congressional District 12,Ohio,5001500US3912,753567,34431,-0.9543093049,-719136,0.04569069505
3913,311,24305,42373,0.7433861345,18068,"Congressional District 13 (115th Congress), Ohio",13,39,3913,Congressional District 13,Ohio,5001500US3913,711936,82516,-0.8840963233,-629420,0.1159036767
3914,312,46738,62811,0.3438957593,16073,"Congressional District 14 (115th Congress), Ohio",14,39,3914,Congressional District 14,Ohio,5001500US3914,718097,31372,-0.9563123088,-686725,0.04368769122
3915,313,51358,57874,0.1268740995,6516,"Congressional District 15 (115th Congress), Ohio",15,39,3915,Congressional District 15,Ohio,5001500US3915,741447,28539,-0.9615090492,-712908,0.0384909508
3916,314,48570,62293,0.282540663,13723,"Congressional District 16 (115th Congress), Ohio",16,39,3916,Congressional District 16,Ohio,5001500US3916,722007,16045,-0.9777772238,-705962,0.02222277623
4001,315,28632,51527,0.7996297849,22895,"Congressional District 1 (115th Congress), Oklahoma",1,40,4001,Congressional District 1,Oklahoma,5001500US4001,781427,66904,-0.9143822776,-714523,0.08561772245
4002,316,25952,40205,0.5492062269,14253,"Congressional District 2 (115th Congress), Oklahoma",2,40,4002,Congressional District 2,Oklahoma,5001500US4002,748897,26300,-0.964881686,-722597,0.035118314
4003,317,31779,49178,0.5474999213,17399,"Congressional District 3 (115th Congress), Oklahoma",3,40,4003,Congressional District 3,Oklahoma,5001500US4003,772392,27978,-0.9637774601,-744414,0.03622253985
4004,318,39250,52339,0.333477707,13089,"Congressional District 4 (115th Congress), Oklahoma",4,40,4004,Congressional District 4,Oklahoma,5001500US4004,777882,52450,-0.9325733209,-725432,0.06742667911
4005,319,31059,47442,0.5274799575,16383,"Congressional District 5 (115th Congress), Oklahoma",5,40,4005,Congressional District 5,Oklahoma,5001500US4005,794991,107663,-0.8645733096,-687328,0.1354266904
4101,320,53152,66106,0.2437161349,12954,"Congressional District 1 (115th Congress), Oregon",1,41,4101,Congressional District 1,Oregon,5001500US4101,807470,12797,-0.9841517332,-794673,0.01584826681
4102,321,23073,46384,1.010315087,23311,"Congressional District 2 (115th Congress), Oregon",2,41,4102,Congressional District 2,Oregon,5001500US4102,788709,4862,-0.9938354957,-783847,0.006164504272
4103,322,27473,57649,1.098387508,30176,"Congressional District 3 (115th Congress), Oregon",3,41,4103,Congressional District 3,Oregon,5001500US4103,811147,41782,-0.9484902243,-769365,0.05150977566
4104,323,26505,44180,0.6668553103,17675,"Congressional District 4 (115th Congress), Oregon",4,41,4104,Congressional District 4,Oregon,5001500US4104,779056,6648,-0.9914665955,-772408,0.008533404531
4105,324,43233,56481,0.3064325862,13248,"Congressional District 5 (115th Congress), Oregon",5,41,4105,Congressional District 5,Oregon,5001500US4105,795885,7923,-0.9900450442,-787962,0.009954955804
4201,325,34648,42667,0.2314419303,8019,"Congressional District 1 (115th Congress), Pennsylvania",1,42,4201,Congressional District 1,Pennsylvania,5001500US4201,718736,256862,-0.6426198215,-461874,0.3573801785
4202,326,28519,38637,0.3547810232,10118,"Congressional District 2 (115th Congress), Pennsylvania",2,42,4202,Congressional District 2,Pennsylvania,5001500US4202,712388,413788,-0.4191536073,-298600,0.5808463927
4203,327,25463,49130,0.9294662844,23667,"Congressional District 3 (115th Congress), Pennsylvania",3,42,4203,Congressional District 3,Pennsylvania,5001500US4203,697809,32453,-0.9534930045,-665356,0.04650699547
4204,328,35532,59226,0.6668355285,23694,"Congressional District 4 (115th Congress), Pennsylvania",4,42,4204,Congressional District 4,Pennsylvania,5001500US4204,717233,56307,-0.9214941309,-660926,0.07850586908
4205,329,31250,47533,0.521056,16283,"Congressional District 5 (115th Congress), Pennsylvania",5,42,4205,Congressional District 5,Pennsylvania,5001500US4205,705575,17788,-0.9747893562,-687787,0.0252106438
4206,330,55319,77580,0.402411468,22261,"Congressional District 6 (115th Congress), Pennsylvania",6,42,4206,Congressional District 6,Pennsylvania,5001500US4206,722755,30785,-0.9574060366,-691970,0.04259396338
4207,331,55960,82483,0.4739635454,26523,"Congressional District 7 (115th Congress), Pennsylvania",7,42,4207,Congressional District 7,Pennsylvania,5001500US4207,717691,40227,-0.9439494156,-677464,0.05605058444
4208,332,49503,79615,0.6082863665,30112,"Congressional District 8 (115th Congress), Pennsylvania",8,42,4208,Congressional District 8,Pennsylvania,5001500US4208,708465,27070,-0.9617906319,-681395,0.03820936814
4209,333,28889,46561,0.6117207242,17672,"Congressional District 9 (115th Congress), Pennsylvania",9,42,4209,Congressional District 9,Pennsylvania,5001500US4209,698749,19665,-0.971856847,-679084,0.02814315298
4210,334,41234,51517,0.2493815783,10283,"Congressional District 10 (115th Congress), Pennsylvania",10,42,4210,Congressional District 10,Pennsylvania,5001500US4210,701757,24463,-0.9651403549,-677294,0.03485964515
4211,335,40178,52531,0.3074568172,12353,"Congressional District 11 (115th Congress), Pennsylvania",11,42,4211,Congressional District 11,Pennsylvania,5001500US4211,706988,37429,-0.9470585074,-669559,0.05294149264
4212,336,33910,57825,0.705249189,23915,"Congressional District 12 (115th Congress), Pennsylvania",12,42,4212,Congressional District 12,Pennsylvania,5001500US4212,702324,22096,-0.9685387371,-680228,0.03146126289
4213,337,43493,57623,0.3248798657,14130,"Congressional District 13 (115th Congress), Pennsylvania",13,42,4213,Congressional District 13,Pennsylvania,5001500US4213,723656,139230,-0.8076019545,-584426,0.1923980455
4214,338,27688,43329,0.5649017625,15641,"Congressional District 14 (115th Congress), Pennsylvania",14,42,4214,Congressional District 14,Pennsylvania,5001500US4214,702800,151000,-0.7851451338,-551800,0.2148548662
4215,339,38835,60100,0.5475730655,21265,"Congressional District 15 (115th Congress), Pennsylvania",15,42,4215,Congressional District 15,Pennsylvania,5001500US4215,719408,35210,-0.9510569802,-684198,0.04894301982
4216,340,33962,55641,0.6383310759,21679,"Congressional District 16 (115th Congress), Pennsylvania",16,42,4216,Congressional District 16,Pennsylvania,5001500US4216,722007,47589,-0.9340878967,-674418,0.06591210335
4217,341,43199,49619,0.1486145513,6420,"Congressional District 17 (115th Congress), Pennsylvania",17,42,4217,Congressional District 17,Pennsylvania,5001500US4217,698821,42332,-0.9394236865,-656489,0.06057631353
4218,342,36027,62283,0.7287867433,26256,"Congressional District 18 (115th Congress), Pennsylvania",18,42,4218,Congressional District 18,Pennsylvania,5001500US4218,706815,16269,-0.9769826617,-690546,0.02301733834
4401,343,36419,53699,0.4744776078,17280,"Congressional District 1 (115th Congress), Rhode Island",1,44,4401,Congressional District 1,Rhode Island,5001500US4401,529708,47930,-0.9095161863,-481778,0.09048381372
4402,344,38580,63107,0.6357439088,24527,"Congressional District 2 (115th Congress), Rhode Island",2,44,4402,Congressional District 2,Rhode Island,5001500US4402,524783,20956,-0.960067304,-503827,0.03993269599
4501,345,37987,61354,0.6151314924,23367,"Congressional District 1 (115th Congress), South Carolina",1,45,4501,Congressional District 1,South Carolina,5001500US4501,731010,138612,-0.8103828949,-592398,0.1896171051
4502,346,41699,55143,0.3224058131,13444,"Congressional District 2 (115th Congress), South Carolina",2,45,4502,Congressional District 2,South Carolina,5001500US4502,689145,160845,-0.7666020939,-528300,0.2333979061
4503,347,28671,42513,0.4827874856,13842,"Congressional District 3 (115th Congress), South Carolina",3,45,4503,Congressional District 3,South Carolina,5001500US4503,672526,124650,-0.8146540059,-547876,0.1853459941
4504,348,30820,49093,0.5928942245,18273,"Congressional District 4 (115th Congress), South Carolina",4,45,4504,Congressional District 4,South Carolina,5001500US4504,697852,133388,-0.808859185,-564464,0.191140815
4505,349,30156,46062,0.5274572224,15906,"Congressional District 5 (115th Congress), South Carolina",5,45,4505,Congressional District 5,South Carolina,5001500US4505,687477,184296,-0.7319241226,-503181,0.2680758774
4506,350,28147,35014,0.2439691619,6867,"Congressional District 6 (115th Congress), South Carolina",6,45,4506,Congressional District 6,South Carolina,5001500US4506,667168,380034,-0.4303773562,-287134,0.5696226438
4507,351,27640,41296,0.4940665702,13656,"Congressional District 7 (115th Congress), South Carolina",7,45,4507,Congressional District 7,South Carolina,5001500US4507,689427,200543,-0.7091164112,-488884,0.2908835888
4600,352,35916,52078,0.4499944315,16162,"Congressional District (at Large) (115th Congress), South Dakota",0,46,4600,Congressional District (at Large),South Dakota,5001500US4600,851058,14078,-0.9834582367,-836980,0.01654176331
4701,353,26458,39305,0.4855620228,12847,"Congressional District 1 (115th Congress), Tennessee",1,47,4701,Congressional District 1,Tennessee,5001500US4701,711220,15709,-0.9779126009,-695511,0.02208739912
4702,354,28513,48615,0.705011749,20102,"Congressional District 2 (115th Congress), Tennessee",2,47,4702,Congressional District 2,Tennessee,5001500US4702,726682,45994,-0.9367068401,-680688,0.06329315987
4703,355,29506,43943,0.4892903138,14437,"Congressional District 3 (115th Congress), Tennessee",3,47,4703,Congressional District 3,Tennessee,5001500US4703,719834,78005,-0.891634738,-641829,0.108365262
4704,356,40111,48420,0.2071501583,8309,"Congressional District 4 (115th Congress), Tennessee",4,47,4704,Congressional District 4,Tennessee,5001500US4704,745636,62768,-0.9158195152,-682868,0.08418048485
4705,357,36010,50317,0.3973063038,14307,"Congressional District 5 (115th Congress), Tennessee",5,47,4705,Congressional District 5,Tennessee,5001500US4705,747388,186852,-0.74999331,-560536,0.25000669
4706,358,43287,47925,0.1071453323,4638,"Congressional District 6 (115th Congress), Tennessee",6,47,4706,Congressional District 6,Tennessee,5001500US4706,737895,31259,-0.9576376043,-706636,0.04236239573
4707,359,36666,51936,0.4164621175,15270,"Congressional District 7 (115th Congress), Tennessee",7,47,4707,Congressional District 7,Tennessee,5001500US4707,742791,73971,-0.9004147869,-668820,0.09958521307
4708,360,35025,53877,0.5382441113,18852,"Congressional District 8 (115th Congress), Tennessee",8,47,4708,Congressional District 8,Tennessee,5001500US4708,708571,140925,-0.801113791,-567646,0.198886209
4709,361,31793,37644,0.1840342214,5851,"Congressional District 9 (115th Congress), Tennessee",9,47,4709,Congressional District 9,Tennessee,5001500US4709,707992,465094,-0.3430801478,-242898,0.6569198522
4801,362,27562,45724,0.6589507293,18162,"Congressional District 1 (115th Congress), Texas",1,48,4801,Congressional District 1,Texas,5001500US4801,711851,125899,-0.8231385501,-585952,0.1768614499
4802,363,57353,74099,0.291981239,16746,"Congressional District 2 (115th Congress), Texas",2,48,4802,Congressional District 2,Texas,5001500US4802,758738,82727,-0.8909676331,-676011,0.1090323669
4803,364,64829,86783,0.3386447423,21954,"Congressional District 3 (115th Congress), Texas",3,48,4803,Congressional District 3,Texas,5001500US4803,791520,72355,-0.9085872751,-719165,0.09141272488
4804,365,27382,49540,0.8092177343,22158,"Congressional District 4 (115th Congress), Texas",4,48,4804,Congressional District 4,Texas,5001500US4804,721526,75729,-0.8950432833,-645797,0.1049567167
4805,366,36237,47410,0.3083312636,11173,"Congressional District 5 (115th Congress), Texas",5,48,4805,Congressional District 5,Texas,5001500US4805,731797,111125,-0.8481477787,-620672,0.1518522213
4806,367,52355,62450,0.19281826,10095,"Congressional District 6 (115th Congress), Texas",6,48,4806,Congressional District 6,Texas,5001500US4806,745202,147491,-0.8020791678,-597711,0.1979208322
4807,368,49127,71343,0.4522156859,22216,"Congressional District 7 (115th Congress), Texas",7,48,4807,Congressional District 7,Texas,5001500US4807,753088,98849,-0.8687417672,-654239,0.1312582328
4808,369,39114,64196,0.641253771,25082,"Congressional District 8 (115th Congress), Texas",8,48,4808,Congressional District 8,Texas,5001500US4808,782315,64223,-0.9179064699,-718092,0.0820935301
4809,370,42095,44024,0.04582491982,1929,"Congressional District 9 (115th Congress), Texas",9,48,4809,Congressional District 9,Texas,5001500US4809,762611,287960,-0.6224025093,-474651,0.3775974907
4810,371,50059,69430,0.3869633832,19371,"Congressional District 10 (115th Congress), Texas",10,48,4810,Congressional District 10,Texas,5001500US4810,783310,82961,-0.8940891856,-700349,0.1059108144
4811,372,37590,52461,0.3956105347,14871,"Congressional District 11 (115th Congress), Texas",11,48,4811,Congressional District 11,Texas,5001500US4811,744592,28352,-0.9619227711,-716240,0.03807722887
4812,373,43031,62081,0.442704097,19050,"Congressional District 12 (115th Congress), Texas",12,48,4812,Congressional District 12,Texas,5001500US4812,758403,63915,-0.9157242258,-694488,0.08427577423
4813,374,27434,49229,0.7944521397,21795,"Congressional District 13 (115th Congress), Texas",13,48,4813,Congressional District 13,Texas,5001500US4813,707120,38065,-0.9461689671,-669055,0.05383103292
4814,375,32721,55501,0.6961889918,22780,"Congressional District 14 (115th Congress), Texas",14,48,4814,Congressional District 14,Texas,5001500US4814,726919,144947,-0.8006008923,-581972,0.1993991077
4815,376,64232,41865,-0.34822207,-22367,"Congressional District 15 (115th Congress), Texas",15,48,4815,Congressional District 15,Texas,5001500US4815,753132,13811,-0.9816619132,-739321,0.01833808682
4816,377,47973,43683,-0.08942530173,-4290,"Congressional District 16 (115th Congress), Texas",16,48,4816,Congressional District 16,Texas,5001500US4816,732018,28712,-0.9607769208,-703306,0.03922307921
4817,378,33005,49401,0.4967732162,16396,"Congressional District 17 (115th Congress), Texas",17,48,4817,Congressional District 17,Texas,5001500US4817,738775,97772,-0.8676565937,-641003,0.1323434063
4818,379,32183,42352,0.3159742721,10169,"Congressional District 18 (115th Congress), Texas",18,48,4818,Congressional District 18,Texas,5001500US4818,749983,284630,-0.620484731,-465353,0.379515269
4819,380,31299,46727,0.4929230966,15428,"Congressional District 19 (115th Congress), Texas",19,48,4819,Congressional District 19,Texas,5001500US4819,718947,44506,-0.9380955759,-674441,0.06190442411
4820,381,44894,48594,0.08241635853,3700,"Congressional District 20 (115th Congress), Texas",20,48,4820,Congressional District 20,Texas,5001500US4820,762155,41124,-0.9460424717,-721031,0.05395752832
4821,382,45829,63979,0.3960374435,18150,"Congressional District 21 (115th Congress), Texas",21,48,4821,Congressional District 21,Texas,5001500US4821,762036,26378,-0.9653848375,-735658,0.03461516254
4822,383,78222,90194,0.1530515712,11972,"Congressional District 22 (115th Congress), Texas",22,48,4822,Congressional District 22,Texas,5001500US4822,814295,110473,-0.8643329506,-703822,0.1356670494
4823,384,52083,51081,-0.01923852313,-1002,"Congressional District 23 (115th Congress), Texas",23,48,4823,Congressional District 23,Texas,5001500US4823,741364,25324,-0.9658413411,-716040,0.0341586589
4824,385,46466,67197,0.4461541772,20731,"Congressional District 24 (115th Congress), Texas",24,48,4824,Congressional District 24,Texas,5001500US4824,759717,84115,-0.8892811402,-675602,0.1107188598
4825,386,45164,63799,0.4126073864,18635,"Congressional District 25 (115th Congress), Texas",25,48,4825,Congressional District 25,Texas,5001500US4825,746615,53729,-0.9280365382,-692886,0.07196346176
4826,387,63039,81425,0.291660718,18386,"Congressional District 26 (115th Congress), Texas",26,48,4826,Congressional District 26,Texas,5001500US4826,796179,59649,-0.9250809177,-736530,0.07491908227
4827,388,33490,51398,0.5347267841,17908,"Congressional District 27 (115th Congress), Texas",27,48,4827,Congressional District 27,Texas,5001500US4827,726807,38644,-0.9468304516,-688163,0.05316954845
4828,389,57997,45253,-0.2197355036,-12744,"Congressional District 28 (115th Congress), Texas",28,48,4828,Congressional District 28,Texas,5001500US4828,735440,30864,-0.9580332862,-704576,0.0419667138
4829,390,36106,39571,0.09596742924,3465,"Congressional District 29 (115th Congress), Texas",29,48,4829,Congressional District 29,Texas,5001500US4829,729879,77945,-0.8932083263,-651934,0.1067916737
4830,391,36792,42708,0.1607958252,5916,"Congressional District 30 (115th Congress), Texas",30,48,4830,Congressional District 30,Texas,5001500US4830,745784,328105,-0.5600535812,-417679,0.4399464188
4831,392,48231,65636,0.3608674919,17405,"Congressional District 31 (115th Congress), Texas",31,48,4831,Congressional District 31,Texas,5001500US4831,782478,89621,-0.8854651505,-692857,0.1145348495
4832,393,44532,65544,0.4718404743,21012,"Congressional District 32 (115th Congress), Texas",32,48,4832,Congressional District 32,Texas,5001500US4832,742056,96229,-0.8703211078,-645827,0.1296788922
4833,394,28334,36755,0.2972047717,8421,"Congressional District 33 (115th Congress), Texas",33,48,4833,Congressional District 33,Texas,5001500US4833,719958,115467,-0.8396198112,-604491,0.1603801888
4834,395,36480,36417,-0.001726973684,-63,"Congressional District 34 (115th Congress), Texas",34,48,4834,Congressional District 34,Texas,5001500US4834,718321,10075,-0.9859742371,-708246,0.01402576286
4835,396,33720,43311,0.284430605,9591,"Congressional District 35 (115th Congress), Texas",35,48,4835,Congressional District 35,Texas,5001500US4835,777259,73531,-0.9053970427,-703728,0.09460295732
4836,397,37017,56549,0.5276494584,19532,"Congressional District 36 (115th Congress), Texas",36,48,4836,Congressional District 36,Texas,5001500US4836,724245,65831,-0.9091039634,-658414,0.09089603656
4901,398,37813,62875,0.6627879301,25062,"Congressional District 1 (115th Congress), Utah",1,49,4901,Congressional District 1,Utah,5001500US4901,730389,7629,-0.989554881,-722760,0.01044511897
4902,399,35170,56311,0.6011088996,21141,"Congressional District 2 (115th Congress), Utah",2,49,4902,Congressional District 2,Utah,5001500US4902,727562,9041,-0.9875735676,-718521,0.01242643239
4903,400,60018,66478,0.1076343764,6460,"Congressional District 3 (115th Congress), Utah",3,49,4903,Congressional District 3,Utah,5001500US4903,732869,4297,-0.994136742,-728572,0.005863257963
4904,401,45455,65081,0.4317676823,19626,"Congressional District 4 (115th Congress), Utah",4,49,4904,Congressional District 4,Utah,5001500US4904,757607,11545,-0.9847612284,-746062,0.01523877155
5000,402,42935,56104,0.3067194596,13169,"Congressional District (at Large) (115th Congress), Vermont",0,50,5000,Congressional District (at Large),Vermont,5001500US5000,626249,7404,-0.9881772266,-618845,0.01182277337
5101,403,67174,80492,0.198261232,13318,"Congressional District 1 (115th Congress), Virginia",1,51,5101,Congressional District 1,Virginia,5001500US5101,767681,127204,-0.8343009662,-640477,0.1656990338
5102,404,46063,63681,0.3824761739,17618,"Congressional District 2 (115th Congress), Virginia",2,51,5102,Congressional District 2,Virginia,5001500US5102,739007,147943,-0.7998083915,-591064,0.2001916085
5103,405,39714,50822,0.279699854,11108,"Congressional District 3 (115th Congress), Virginia",3,51,5103,Congressional District 3,Virginia,5001500US5103,738466,341579,-0.5374478988,-396887,0.4625521012
5104,406,37622,52464,0.3945032162,14842,"Congressional District 4 (115th Congress), Virginia",4,51,5104,Congressional District 4,Virginia,5001500US5104,754069,312994,-0.5849265783,-441075,0.4150734217
5105,407,32557,50005,0.5359216144,17448,"Congressional District 5 (115th Congress), Virginia",5,51,5105,Congressional District 5,Virginia,5001500US5105,731805,145359,-0.8013692172,-586446,0.1986307828
5106,408,31231,49798,0.5945054593,18567,"Congressional District 6 (115th Congress), Virginia",6,51,5106,Congressional District 6,Virginia,5001500US5106,744504,80436,-0.891960285,-664068,0.108039715
5107,409,53531,70994,0.326222189,17463,"Congressional District 7 (115th Congress), Virginia",7,51,5107,Congressional District 7,Virginia,5001500US5107,762523,136300,-0.8212512934,-626223,0.1787487066
5108,410,63965,100649,0.5735011334,36684,"Congressional District 8 (115th Congress), Virginia",8,51,5108,Congressional District 8,Virginia,5001500US5108,778376,107705,-0.8616285703,-670671,0.1383714297
5109,411,27331,40855,0.4948227288,13524,"Congressional District 9 (115th Congress), Virginia",9,51,5109,Congressional District 9,Virginia,5001500US5109,717480,39174,-0.9454005687,-678306,0.05459943134
5110,412,93562,116069,0.2405570638,22507,"Congressional District 10 (115th Congress), Virginia",10,51,5110,Congressional District 10,Virginia,5001500US5110,796568,54460,-0.9316317,-742108,0.06836830001
5111,413,85434,105024,0.2292998104,19590,"Congressional District 11 (115th Congress), Virginia",11,51,5111,Congressional District 11,Virginia,5001500US5111,779822,103198,-0.8676646722,-676624,0.1323353278
5301,414,86783,85293,-0.01716926126,-1490,"Congressional District 1 (115th Congress), Washington",1,53,5301,Congressional District 1,Washington,5001500US5301,716614,8774,-0.9877563095,-707840,0.01224369047
5302,415,53064,61475,0.1585067089,8411,"Congressional District 2 (115th Congress), Washington",2,53,5302,Congressional District 2,Washington,5001500US5302,706518,20640,-0.9707863069,-685878,0.02921369307
5303,416,41335,56436,0.3653320431,15101,"Congressional District 3 (115th Congress), Washington",3,53,5303,Congressional District 3,Washington,5001500US5303,699966,10174,-0.9854650083,-689792,0.0145349917
5304,417,40603,51434,0.2667536882,10831,"Congressional District 4 (115th Congress), Washington",4,53,5304,Congressional District 4,Washington,5001500US5304,704697,8248,-0.9882956789,-696449,0.01170432115
5305,418,30261,48516,0.6032517101,18255,"Congressional District 5 (115th Congress), Washington",5,53,5305,Congressional District 5,Washington,5001500US5305,691150,11010,-0.9840700282,-680140,0.01592997179
5306,419,39416,57285,0.4533438198,17869,"Congressional District 6 (115th Congress), Washington",6,53,5306,Congressional District 6,Washington,5001500US5306,686051,24226,-0.9646877564,-661825,0.03531224355
5307,420,33345,75568,1.266246814,42223,"Congressional District 7 (115th Congress), Washington",7,53,5307,Congressional District 7,Washington,5001500US5307,729532,31039,-0.9574535456,-698493,0.04254645444
5308,421,61080,75953,0.2435003274,14873,"Congressional District 8 (115th Congress), Washington",8,53,5308,Congressional District 8,Washington,5001500US5308,713794,20374,-0.9714567508,-693420,0.02854324917
5309,422,39551,68915,0.7424338196,29364,"Congressional District 9 (115th Congress), Washington",9,53,5309,Congressional District 9,Washington,5001500US5309,714192,78064,-0.8906960593,-636128,0.1093039407
5310,423,54624,59107,0.08207015231,4483,"Congressional District 10 (115th Congress), Washington",10,53,5310,Congressional District 10,Washington,5001500US5310,710632,44441,-0.9374627093,-666191,0.06253729075
5401,424,27296,43285,0.5857634818,15989,"Congressional District 1 (115th Congress), West Virginia",1,54,5401,Congressional District 1,West Virginia,5001500US5401,617075,15639,-0.9746562411,-601436,0.02534375886
5402,425,39161,47628,0.2162100049,8467,"Congressional District 2 (115th Congress), West Virginia",2,54,5402,Congressional District 2,West Virginia,5001500US5402,625142,25081,-0.9598795154,-600061,0.04012048463
5403,426,25384,37243,0.4671840529,11859,"Congressional District 3 (115th Congress), West Virginia",3,54,5403,Congressional District 3,West Virginia,5001500US5403,603875,22585,-0.9625998758,-581290,0.0374001242
5501,427,28327,60528,1.136759982,32201,"Congressional District 1 (115th Congress), Wisconsin",1,55,5501,Congressional District 1,Wisconsin,5001500US5501,715455,38862,-0.9456821184,-676593,0.05431788163
5502,428,29733,60946,1.049776343,31213,"Congressional District 2 (115th Congress), Wisconsin",2,55,5502,Congressional District 2,Wisconsin,5001500US5502,741376,31953,-0.9569004122,-709423,0.04309958779
5503,429,30660,50985,0.6629158513,20325,"Congressional District 3 (115th Congress), Wisconsin",3,55,5503,Congressional District 3,Wisconsin,5001500US5503,718576,7645,-0.9893609027,-710931,0.01063909733
5504,430,27143,40400,0.4884132189,13257,"Congressional District 4 (115th Congress), Wisconsin",4,55,5504,Congressional District 4,Wisconsin,5001500US5504,715266,243228,-0.6599474881,-472038,0.3400525119
5505,431,39851,65816,0.6515520313,25965,"Congressional District 5 (115th Congress), Wisconsin",5,55,5505,Congressional District 5,Wisconsin,5001500US5505,719342,14380,-0.9800095087,-704962,0.01999049131
5506,432,30379,55310,0.8206655914,24931,"Congressional District 6 (115th Congress), Wisconsin",6,55,5506,Congressional District 6,Wisconsin,5001500US5506,712501,11166,-0.984328443,-701335,0.01567155695
5507,433,40841,50744,0.2424769227,9903,"Congressional District 7 (115th Congress), Wisconsin",7,55,5507,Congressional District 7,Wisconsin,5001500US5507,709035,5195,-0.9926731403,-703840,0.007326859746
5508,434,26332,55380,1.103144463,29048,"Congressional District 8 (115th Congress), Wisconsin",8,55,5508,Congressional District 8,Wisconsin,5001500US5508,723247,9301,-0.9871399397,-713946,0.01286006026
5600,435,44079,59143,0.3417500397,15064,"Congressional District (at Large) (115th Congress), Wyoming",0,56,5600,Congressional District (at Large),Wyoming,5001500US5600,583029,6435,-0.9889628132,-576594,0.01103718683
101,436,26956,44824,0.6628579908,17868,"Congressional District 1 (115th Congress), Alabama",1,1,101,Congressional District 1,Alabama,5001500US0101,699597,194080,-0.7225831443,-505517,0.2774168557
102,437,29348,43173,0.4710712825,13825,"Congressional District 2 (115th Congress), Alabama",2,1,102,Congressional District 2,Alabama,5001500US0102,683013,210862,-0.69127674,-472151,0.30872326
103,438,30393,42953,0.4132530517,12560,"Congressional District 3 (115th Congress), Alabama",3,1,103,Congressional District 3,Alabama,5001500US0103,700551,178003,-0.7459100051,-522548,0.2540899949
104,439,28789,40267,0.3986939456,11478,"Congressional District 4 (115th Congress), Alabama",4,1,104,Congressional District 4,Alabama,5001500US0104,683607,47540,-0.9304571194,-636067,0.06954288063
105,440,35509,51830,0.459629953,16321,"Congressional District 5 (115th Congress), Alabama",5,1,105,Congressional District 5,Alabama,5001500US0105,704796,121575,-0.8275032775,-583221,0.1724967225
106,441,46713,60706,0.2995525871,13993,"Congressional District 6 (115th Congress), Alabama",6,1,106,Congressional District 6,Alabama,5001500US0106,694370,101997,-0.8531085732,-592373,0.1468914268
107,442,27167,33366,0.2281812493,6199,"Congressional District 7 (115th Congress), Alabama",7,1,107,Congressional District 7,Alabama,5001500US0107,675230,427996,-0.3661478311,-247234,0.6338521689
200,443,53800,74444,0.3837174721,20644,"Congressional District (at Large) (115th Congress), Alaska",0,2,200,Congressional District (at Large),Alaska,5001500US0200,736855,24443,-0.9668279377,-712412,0.03317206235
401,444,50520,48583,-0.03834125099,-1937,"Congressional District 1 (115th Congress), Arizona",1,4,401,Congressional District 1,Arizona,5001500US0401,735985,17121,-0.9767372976,-718864,0.02326270236
402,445,36736,48125,0.3100228659,11389,"Congressional District 2 (115th Congress), Arizona",2,4,402,Congressional District 2,Arizona,5001500US0402,720794,29891,-0.9585304539,-690903,0.04146954608
403,446,44424,42173,-0.05067080857,-2251,"Congressional District 3 (115th Congress), Arizona",3,4,403,Congressional District 3,Arizona,5001500US0403,739672,34504,-0.9533522967,-705168,0.04664770331
404,447,51497,45933,-0.1080451288,-5564,"Congressional District 4 (115th Congress), Arizona",4,4,404,Congressional District 4,Arizona,5001500US0404,738648,13422,-0.9818289632,-725226,0.01817103681
405,448,60921,68292,0.1209927611,7371,"Congressional District 5 (115th Congress), Arizona",5,4,405,Congressional District 5,Arizona,5001500US0405,765403,22784,-0.9702326748,-742619,0.02976732519
406,449,41136,64223,0.5612359004,23087,"Congressional District 6 (115th Congress), Arizona",6,4,406,Congressional District 6,Arizona,5001500US0406,752459,20352,-0.9729526791,-732107,0.02704732085
407,450,29879,36097,0.2081060276,6218,"Congressional District 7 (115th Congress), Arizona",7,4,407,Congressional District 7,Arizona,5001500US0407,767495,74685,-0.9026899198,-692810,0.0973100802
408,451,53239,60342,0.1334172317,7103,"Congressional District 8 (115th Congress), Arizona",8,4,408,Congressional District 8,Arizona,5001500US0408,753310,33771,-0.9551698504,-719539,0.04483014961
409,452,34613,52245,0.5094039812,17632,"Congressional District 9 (115th Congress), Arizona",9,4,409,Congressional District 9,Arizona,5001500US0409,754811,40580,-0.9462381974,-714231,0.05376180262
501,453,23858,38289,0.6048704837,14431,"Congressional District 1 (115th Congress), Arkansas",1,5,501,Congressional District 1,Arkansas,5001500US0501,724990,130344,-0.8202126926,-594646,0.1797873074
502,454,33192,48103,0.4492347554,14911,"Congressional District 2 (115th Congress), Arkansas",2,5,502,Congressional District 2,Arkansas,5001500US0502,754821,167337,-0.7783090296,-587484,0.2216909704
503,455,31311,46332,0.4797355562,15021,"Congressional District 3 (115th Congress), Arkansas",3,5,503,Congressional District 3,Arkansas,5001500US0503,772676,22452,-0.9709425425,-750224,0.02905745746
504,456,24815,37758,0.5215796897,12943,"Congressional District 4 (115th Congress), Arkansas",4,5,504,Congressional District 4,Arkansas,5001500US0504,715985,140505,-0.8037598553,-575480,0.1962401447
601,457,38370,46594,0.2143341152,8224,"Congressional District 1 (115th Congress), California",1,6,601,Congressional District 1,California,5001500US0601,703985,10053,-0.9857198662,-693932,0.01428013381
602,458,47315,65158,0.3771108528,17843,"Congressional District 2 (115th Congress), California",2,6,602,Congressional District 2,California,5001500US0602,713613,10745,-0.9849428191,-702868,0.01505718085
603,459,53797,57926,0.07675149172,4129,"Congressional District 3 (115th Congress), California",3,6,603,Congressional District 3,California,5001500US0603,722896,43299,-0.9401034174,-679597,0.05989658263
604,460,63086,69051,0.0945534667,5965,"Congressional District 4 (115th Congress), California",4,6,604,Congressional District 4,California,5001500US0604,718699,9472,-0.9868206301,-709227,0.01317936994
605,461,54059,67273,0.244436634,13214,"Congressional District 5 (115th Congress), California",5,6,605,Congressional District 5,California,5001500US0605,724966,46276,-0.936168041,-678690,0.06383195902
606,462,33804,49048,0.45095255,15244,"Congressional District 6 (115th Congress), California",6,6,606,Congressional District 6,California,5001500US0606,734450,91465,-0.8754646334,-642985,0.1245353666
607,463,51375,66846,0.3011386861,15471,"Congressional District 7 (115th Congress), California",7,6,607,Congressional District 7,California,5001500US0607,732954,54965,-0.9250089364,-677989,0.07499106356
608,464,31772,47171,0.4846720383,15399,"Congressional District 8 (115th Congress), California",8,6,608,Congressional District 8,California,5001500US0608,716168,58895,-0.9177637091,-657273,0.08223629093
609,465,41047,57832,0.4089214803,16785,"Congressional District 9 (115th Congress), California",9,6,609,Congressional District 9,California,5001500US0609,739025,65639,-0.9111816244,-673386,0.08881837556
610,466,47407,56256,0.1866601979,8849,"Congressional District 10 (115th Congress), California",10,6,610,Congressional District 10,California,5001500US0610,729022,23204,-0.9681710566,-705818,0.03182894343
611,467,47190,78487,0.663212545,31297,"Congressional District 11 (115th Congress), California",11,6,611,Congressional District 11,California,5001500US0611,739386,62209,-0.9158639736,-677177,0.08413602638
612,468,26423,88364,2.344207698,61941,"Congressional District 12 (115th Congress), California",12,6,612,Congressional District 12,California,5001500US0612,740337,40213,-0.9456828444,-700124,0.05431715557
613,469,38274,64948,0.6969221926,26674,"Congressional District 13 (115th Congress), California",13,6,613,Congressional District 13,California,5001500US0613,740683,131139,-0.8229485488,-609544,0.1770514512
614,470,54226,93666,0.7273263748,39440,"Congressional District 14 (115th Congress), California",14,6,614,Congressional District 14,California,5001500US0614,741332,22630,-0.969473866,-718702,0.03052613404
615,471,58799,97232,0.6536335652,38433,"Congressional District 15 (115th Congress), California",15,6,615,Congressional District 15,California,5001500US0615,751439,45912,-0.9389012282,-705527,0.06109877182
616,472,24006,38381,0.5988086312,14375,"Congressional District 16 (115th Congress), California",16,6,616,Congressional District 16,California,5001500US0616,721109,42971,-0.940409841,-678138,0.05959015905
617,473,69882,107946,0.5446896196,38064,"Congressional District 17 (115th Congress), California",17,6,617,Congressional District 17,California,5001500US0617,748800,19207,-0.9743496261,-729593,0.02565037393
618,474,68487,112702,0.6455969746,44215,"Congressional District 18 (115th Congress), California",18,6,618,Congressional District 18,California,5001500US0618,730782,13986,-0.9808615976,-716796,0.01913840242
619,475,63917,85010,0.3300061017,21093,"Congressional District 19 (115th Congress), California",19,6,619,Congressional District 19,California,5001500US0619,748954,22902,-0.969421353,-726052,0.03057864702
620,476,61606,62732,0.01827744051,1126,"Congressional District 20 (115th Congress), California",20,6,620,Congressional District 20,California,5001500US0620,729525,14241,-0.9804790789,-715284,0.01952092115
621,477,31914,38462,0.2051764116,6548,"Congressional District 21 (115th Congress), California",21,6,621,Congressional District 21,California,5001500US0621,711464,29486,-0.9585558791,-681978,0.04144412086
622,478,35334,53868,0.5245372729,18534,"Congressional District 22 (115th Congress), California",22,6,622,Congressional District 22,California,5001500US0622,739449,23239,-0.9685725452,-716210,0.03142745477
623,479,37532,56167,0.4965096451,18635,"Congressional District 23 (115th Congress), California",23,6,623,Congressional District 23,California,5001500US0623,730050,47269,-0.93525238,-682781,0.06474762003
624,480,54294,64676,0.1912181825,10382,"Congressional District 24 (115th Congress), California",24,6,624,Congressional District 24,California,5001500US0624,727935,14455,-0.9801424578,-713480,0.01985754223
625,481,42492,73819,0.7372446578,31327,"Congressional District 25 (115th Congress), California",25,6,625,Congressional District 25,California,5001500US0625,719970,56017,-0.9221953693,-663953,0.07780463075
626,482,68225,76719,0.1244998168,8494,"Congressional District 26 (115th Congress), California",26,6,626,Congressional District 26,California,5001500US0626,720336,13317,-0.981512794,-707019,0.01848720597
627,483,54015,70099,0.2977691382,16084,"Congressional District 27 (115th Congress), California",27,6,627,Congressional District 27,California,5001500US0627,717212,33040,-0.9539327284,-684172,0.0460672716
628,484,48709,58768,0.2065121435,10059,"Congressional District 28 (115th Congress), California",28,6,628,Congressional District 28,California,5001500US0628,716990,19872,-0.9722841323,-697118,0.02771586772
629,485,41909,48293,0.1523300484,6384,"Congressional District 29 (115th Congress), California",29,6,629,Congressional District 29,California,5001500US0629,717765,27812,-0.9612519418,-689953,0.03874805821
630,486,60942,72243,0.1854386138,11301,"Congressional District 30 (115th Congress), California",30,6,630,Congressional District 30,California,5001500US0630,750372,35670,-0.9524635781,-714702,0.04753642193
631,487,40917,55451,0.3552068822,14534,"Congressional District 31 (115th Congress), California",31,6,631,Congressional District 31,California,5001500US0631,733581,77946,-0.8937458849,-655635,0.1062541151
632,488,54679,61288,0.1208690722,6609,"Congressional District 32 (115th Congress), California",32,6,632,Congressional District 32,California,5001500US0632,719110,20624,-0.971320104,-698486,0.02867989598
633,489,71722,99902,0.3929059424,28180,"Congressional District 33 (115th Congress), California",33,6,633,Congressional District 33,California,5001500US0633,713625,20528,-0.9712341916,-693097,0.02876580837
634,490,24072,37136,0.5427052177,13064,"Congressional District 34 (115th Congress), California",34,6,634,Congressional District 34,California,5001500US0634,720384,31661,-0.956049829,-688723,0.04395017102
635,491,54387,55900,0.02781914796,1513,"Congressional District 35 (115th Congress), California",35,6,635,Congressional District 35,California,5001500US0635,730260,50009,-0.9315189111,-680251,0.06848108893
636,492,35300,45708,0.2948441926,10408,"Congressional District 36 (115th Congress), California",36,6,636,Congressional District 36,California,5001500US0636,736044,31532,-0.9571601698,-704512,0.04283983023
637,493,36179,51531,0.4243345587,15352,"Congressional District 37 (115th Congress), California",37,6,637,Congressional District 37,California,5001500US0637,722138,169733,-0.7649576674,-552405,0.2350423326
638,494,55556,63212,0.1378068975,7656,"Congressional District 38 (115th Congress), California",38,6,638,Congressional District 38,California,5001500US0638,717228,28530,-0.9602218541,-688698,0.03977814586
639,495,71760,80844,0.1265886288,9084,"Congressional District 39 (115th Congress), California",39,6,639,Congressional District 39,California,5001500US0639,722857,15931,-0.9779610628,-706926,0.02203893716
640,496,30603,41521,0.3567624089,10918,"Congressional District 40 (115th Congress), California",40,6,640,Congressional District 40,California,5001500US0640,709435,34706,-0.9510793801,-674729,0.04892061993
641,497,48736,56824,0.1659553513,8088,"Congressional District 41 (115th Congress), California",41,6,641,Congressional District 41,California,5001500US0641,739304,69152,-0.9064633764,-670152,0.09353662364
642,498,74446,73341,-0.01484297343,-1105,"Congressional District 42 (115th Congress), California",42,6,642,Congressional District 42,California,5001500US0642,761341,40769,-0.9464510646,-720572,0.05354893537
643,499,40542,50355,0.2420452864,9813,"Congressional District 43 (115th Congress), California",43,6,643,Congressional District 43,California,5001500US0643,719530,164990,-0.7706975387,-554540,0.2293024613
644,500,44770,47683,0.06506589234,2913,"Congressional District 44 (115th Congress), California",44,6,644,Congressional District 44,California,5001500US0644,721109,114539,-0.8411627091,-606570,0.1588372909
645,501,86993,93995,0.08048923477,7002,"Congressional District 45 (115th Congress), California",45,6,645,Congressional District 45,California,5001500US0645,749687,14313,-0.9809080323,-735374,0.01909196771
646,502,46347,56465,0.2183097072,10118,"Congressional District 46 (115th Congress), California",46,6,646,Congressional District 46,California,5001500US0646,726307,11811,-0.9837382815,-714496,0.01626171853
647,503,46941,60841,0.2961164014,13900,"Congressional District 47 (115th Congress), California",47,6,647,Congressional District 47,California,5001500US0647,716958,53116,-0.9259147677,-663842,0.07408523233
648,504,69250,83894,0.211465704,14644,"Congressional District 48 (115th Congress), California",48,6,648,Congressional District 48,California,5001500US0648,723983,8496,-0.9882649178,-715487,0.01173508218
649,505,61613,77558,0.2587927872,15945,"Congressional District 49 (115th Congress), California",49,6,649,Congressional District 49,California,5001500US0649,729768,19627,-0.9731051512,-710141,0.02689484877
650,506,57561,65656,0.140633415,8095,"Congressional District 50 (115th Congress), California",50,6,650,Congressional District 50,California,5001500US0650,736001,20671,-0.9719144403,-715330,0.02808555967
651,507,39594,42561,0.0749355963,2967,"Congressional District 51 (115th Congress), California",51,6,651,Congressional District 51,California,5001500US0651,730710,49044,-0.9328817178,-681666,0.06711828222
652,508,54945,86174,0.5683683684,31229,"Congressional District 52 (115th Congress), California",52,6,652,Congressional District 52,California,5001500US0652,742154,22613,-0.9695305826,-719541,0.0304694174
653,509,54088,65332,0.2078834492,11244,"Congressional District 53 (115th Congress), California",53,6,653,Congressional District 53,California,5001500US0653,753024,61894,-0.9178060726,-691130,0.08219392742
801,510,35519,58507,0.6472029055,22988,"Congressional District 1 (115th Congress), Colorado",1,8,801,Congressional District 1,Colorado,5001500US0801,786253,67170,-0.9145694834,-719083,0.08543051664
802,511,48776,72006,0.4762588158,23230,"Congressional District 2 (115th Congress), Colorado",2,8,802,Congressional District 2,Colorado,5001500US0802,771980,6833,-0.9911487344,-765147,0.008851265577
803,512,35897,49977,0.3922333343,14080,"Congressional District 3 (115th Congress), Colorado",3,8,803,Congressional District 3,Colorado,5001500US0803,727398,7407,-0.989817129,-719991,0.010182871
804,513,54293,67813,0.2490192106,13520,"Congressional District 4 (115th Congress), Colorado",4,8,804,Congressional District 4,Colorado,5001500US0804,764153,10764,-0.9859138157,-753389,0.01408618431
805,514,48232,58613,0.2152305523,10381,"Congressional District 5 (115th Congress), Colorado",5,8,805,Congressional District 5,Colorado,5001500US0805,761749,43579,-0.9427908668,-718170,0.05720913319
806,515,47758,72470,0.5174421039,24712,"Congressional District 6 (115th Congress), Colorado",6,8,806,Congressional District 6,Colorado,5001500US0806,779950,71675,-0.9081030835,-708275,0.09189691647
807,516,47001,62806,0.3362694411,15805,"Congressional District 7 (115th Congress), Colorado",7,8,807,Congressional District 7,Colorado,5001500US0807,767812,11921,-0.984474064,-755891,0.01552593604
901,517,45929,68058,0.4818088789,22129,"Congressional District 1 (115th Congress), Connecticut",1,9,901,Congressional District 1,Connecticut,5001500US0901,715145,108646,-0.8480783617,-606499,0.1519216383
902,518,47586,72760,0.5290211407,25174,"Congressional District 2 (115th Congress), Connecticut",2,9,902,Congressional District 2,Connecticut,5001500US0902,709761,27829,-0.9607910268,-681932,0.03920897316
903,519,39969,64333,0.6095724186,24364,"Congressional District 3 (115th Congress), Connecticut",3,9,903,Congressional District 3,Connecticut,5001500US0903,715345,97746,-0.8633582397,-617599,0.1366417603
904,520,45710,90142,0.9720411289,44432,"Congressional District 4 (115th Congress), Connecticut",4,9,904,Congressional District 4,Connecticut,5001500US0904,733754,91900,-0.874753664,-641854,0.125246336
905,521,42504,68984,0.6230001882,26480,"Congressional District 5 (115th Congress), Connecticut",5,9,905,Congressional District 5,Connecticut,5001500US0905,714565,46575,-0.9348204852,-667990,0.06517951481
1000,522,47450,61017,0.2859220232,13567,"Congressional District (at Large) (115th Congress), Delaware",0,10,1000,Congressional District (at Large),Delaware,5001500US1000,934695,203027,-0.7827879683,-731668,0.2172120317
1198,523,40560,72935,0.7982001972,32375,"Delegate District (at Large) (115th Congress), District of Columbia",98,11,1198,Delegate District (at Large),District of Columbia,5001500US1198,659009,318598,-0.5165498499,-340411,0.4834501501
1201,524,34813,51868,0.4899031971,17055,"Congressional District 1 (115th Congress), Florida",1,12,1201,Congressional District 1,Florida,5001500US1201,741949,98794,-0.8668452953,-643155,0.1331547047
1202,525,33148,45464,0.3715457946,12316,"Congressional District 2 (115th Congress), Florida",2,12,1202,Congressional District 2,Florida,5001500US1202,709130,91856,-0.8704666281,-617274,0.1295333719
1203,526,28646,45807,0.5990714236,17161,"Congressional District 3 (115th Congress), Florida",3,12,1203,Congressional District 3,Florida,5001500US1203,713474,115090,-0.8386906881,-598384,0.1613093119
1204,527,48965,63472,0.296272848,14507,"Congressional District 4 (115th Congress), Florida",4,12,1204,Congressional District 4,Florida,5001500US1204,747076,67590,-0.909527277,-679486,0.09047272299
1205,528,30721,37816,0.2309495134,7095,"Congressional District 5 (115th Congress), Florida",5,12,1205,Congressional District 5,Florida,5001500US1205,718313,339446,-0.5274399879,-378867,0.4725600121
1206,529,29753,44026,0.4797163311,14273,"Congressional District 6 (115th Congress), Florida",6,12,1206,Congressional District 6,Florida,5001500US1206,728594,75580,-0.8962659588,-653014,0.1037340412
1207,530,37497,54116,0.44320879,16619,"Congressional District 7 (115th Congress), Florida",7,12,1207,Congressional District 7,Florida,5001500US1207,737984,78877,-0.893118279,-659107,0.106881721
1208,531,33962,49297,0.4515340675,15335,"Congressional District 8 (115th Congress), Florida",8,12,1208,Congressional District 8,Florida,5001500US1208,720695,71883,-0.900258778,-648812,0.09974122201
1209,532,37209,45813,0.2312343788,8604,"Congressional District 9 (115th Congress), Florida",9,12,1209,Congressional District 9,Florida,5001500US1209,780261,103549,-0.8672892788,-676712,0.1327107212
1210,533,36058,48582,0.3473293028,12524,"Congressional District 10 (115th Congress), Florida",10,12,1210,Congressional District 10,Florida,5001500US1210,762103,213742,-0.7195365981,-548361,0.2804634019
1211,534,36295,43053,0.1861964458,6758,"Congressional District 11 (115th Congress), Florida",11,12,1211,Congressional District 11,Florida,5001500US1211,727833,52727,-0.9275561839,-675106,0.0724438161
1212,535,44691,48522,0.08572195744,3831,"Congressional District 12 (115th Congress), Florida",12,12,1212,Congressional District 12,Florida,5001500US1212,729430,33599,-0.9539380064,-695831,0.04606199361
1213,536,31259,45481,0.4549729678,14222,"Congressional District 13 (115th Congress), Florida",13,12,1213,Congressional District 13,Florida,5001500US1213,711119,88398,-0.8756916915,-622721,0.1243083085
1214,537,30192,48636,0.6108903021,18444,"Congressional District 14 (115th Congress), Florida",14,12,1214,Congressional District 14,Florida,5001500US1214,739946,136497,-0.8155311334,-603449,0.1844688666
1215,538,40764,51115,0.2539250319,10351,"Congressional District 15 (115th Congress), Florida",15,12,1215,Congressional District 15,Florida,5001500US1215,745465,107467,-0.855838973,-637998,0.144161027
1216,539,42435,53814,0.2681512902,11379,"Congressional District 16 (115th Congress), Florida",16,12,1216,Congressional District 16,Florida,5001500US1216,760542,64785,-0.9148173276,-695757,0.08518267236
1217,540,33125,44362,0.3392301887,11237,"Congressional District 17 (115th Congress), Florida",17,12,1217,Congressional District 17,Florida,5001500US1217,729130,56877,-0.9219933345,-672253,0.07800666548
1218,541,36595,53675,0.4667304277,17080,"Congressional District 18 (115th Congress), Florida",18,12,1218,Congressional District 18,Florida,5001500US1218,730787,92492,-0.8734350775,-638295,0.1265649225
1219,542,34453,53205,0.5442777117,18752,"Congressional District 19 (115th Congress), Florida",19,12,1219,Congressional District 19,Florida,5001500US1219,757388,58931,-0.922191796,-698457,0.07780820399
1220,543,38304,42440,0.107978279,4136,"Congressional District 20 (115th Congress), Florida",20,12,1220,Congressional District 20,Florida,5001500US1220,752660,402014,-0.4658756942,-350646,0.5341243058
1221,544,44134,53744,0.2177459555,9610,"Congressional District 21 (115th Congress), Florida",21,12,1221,Congressional District 21,Florida,5001500US1221,738761,114521,-0.8449823421,-624240,0.1550176579
1222,545,42218,57254,0.3561514046,15036,"Congressional District 22 (115th Congress), Florida",22,12,1222,Congressional District 22,Florida,5001500US1222,733500,109290,-0.851002045,-624210,0.148997955
1223,546,52266,60606,0.1595683618,8340,"Congressional District 23 (115th Congress), Florida",23,12,1223,Congressional District 23,Florida,5001500US1223,741077,102399,-0.861824075,-638678,0.138175925
1224,547,31848,36368,0.1419241397,4520,"Congressional District 24 (115th Congress), Florida",24,12,1224,Congressional District 24,Florida,5001500US1224,734086,371477,-0.4939598358,-362609,0.5060401642
1225,548,36417,44822,0.2307988028,8405,"Congressional District 25 (115th Congress), Florida",25,12,1225,Congressional District 25,Florida,5001500US1225,744163,36236,-0.951306367,-707927,0.04869363298
1226,549,38928,51148,0.3139128648,12220,"Congressional District 26 (115th Congress), Florida",26,12,1226,Congressional District 26,Florida,5001500US1226,761160,93394,-0.8773004362,-667766,0.1226995638
1227,550,37300,49953,0.3392225201,12653,"Congressional District 27 (115th Congress), Florida",27,12,1227,Congressional District 27,Florida,5001500US1227,737825,39483,-0.9464873107,-698342,0.05351268932
1301,551,34824,47573,0.3660980933,12749,"Congressional District 1 (115th Congress), Georgia",1,13,1301,Congressional District 1,Georgia,5001500US1301,723376,214188,-0.7039050231,-509188,0.2960949769
1302,552,25614,35183,0.3735847583,9569,"Congressional District 2 (115th Congress), Georgia",2,13,1302,Congressional District 2,Georgia,5001500US1302,685992,354016,-0.4839356727,-331976,0.5160643273
1303,553,37785,53655,0.4200079397,15870,"Congressional District 3 (115th Congress), Georgia",3,13,1303,Congressional District 3,Georgia,5001500US1303,714264,169780,-0.7623007739,-544484,0.2376992261
1304,554,47010,50048,0.06462454797,3038,"Congressional District 4 (115th Congress), Georgia",4,13,1304,Congressional District 4,Georgia,5001500US1304,730842,432222,-0.4085972071,-298620,0.5914027929
1305,555,33030,45882,0.3891008174,12852,"Congressional District 5 (115th Congress), Georgia",5,13,1305,Congressional District 5,Georgia,5001500US1305,736159,430934,-0.4146183094,-305225,0.5853816906
1306,556,50991,82390,0.6157753329,31399,"Congressional District 6 (115th Congress), Georgia",6,13,1306,Congressional District 6,Georgia,5001500US1306,731334,100417,-0.8626933795,-630917,0.1373066205
1307,557,53824,67534,0.2547190844,13710,"Congressional District 7 (115th Congress), Georgia",7,13,1307,Congressional District 7,Georgia,5001500US1307,761511,148583,-0.8048839741,-612928,0.1951160259
1308,558,28391,42013,0.4797999366,13622,"Congressional District 8 (115th Congress), Georgia",8,13,1308,Congressional District 8,Georgia,5001500US1308,703464,213571,-0.696400953,-489893,0.303599047
1309,559,26822,47477,0.7700768026,20655,"Congressional District 9 (115th Congress), Georgia",9,13,1309,Congressional District 9,Georgia,5001500US1309,716774,49633,-0.9307550218,-667141,0.06924497819
1310,560,31042,49040,0.5797951163,17998,"Congressional District 10 (115th Congress), Georgia",10,13,1310,Congressional District 10,Georgia,5001500US1310,720981,182502,-0.7468698898,-538479,0.2531301102
1311,561,50147,66258,0.3212754502,16111,"Congressional District 11 (115th Congress), Georgia",11,13,1311,Congressional District 11,Georgia,5001500US1311,735547,119488,-0.8375521891,-616059,0.1624478109
1312,562,29712,41442,0.3947899838,11730,"Congressional District 12 (115th Congress), Georgia",12,13,1312,Congressional District 12,Georgia,5001500US1312,709370,248279,-0.6500007049,-461091,0.3499992951
1313,563,51482,53136,0.03212773397,1654,"Congressional District 13 (115th Congress), Georgia",13,13,1313,Congressional District 13,Georgia,5001500US1313,729459,422523,-0.4207721065,-306936,0.5792278935
1314,564,38431,46248,0.2034035024,7817,"Congressional District 14 (115th Congress), Georgia",14,13,1314,Congressional District 14,Georgia,5001500US1314,700247,61998,-0.9114626696,-638249,0.0885373304
1501,565,72228,76200,0.05499252368,3972,"Congressional District 1 (115th Congress), Hawaii",1,15,1501,Congressional District 1,Hawaii,5001500US1501,707396,14769,-0.9791220193,-692627,0.02087798065
1502,566,56985,67716,0.1883127139,10731,"Congressional District 2 (115th Congress), Hawaii",2,15,1502,Congressional District 2,Hawaii,5001500US1502,706277,11102,-0.9842809549,-695175,0.01571904508
1601,567,60708,49892,-0.1781643276,-10816,"Congressional District 1 (115th Congress), Idaho",1,16,1601,Congressional District 1,Idaho,5001500US1601,833727,3768,-0.995480535,-829959,0.004519465005
1602,568,40537,48356,0.192885512,7819,"Congressional District 2 (115th Congress), Idaho",2,16,1602,Congressional District 2,Idaho,5001500US1602,801756,6665,-0.991686997,-795091,0.008313002959
1701,569,34868,49456,0.4183778823,14588,"Congressional District 1 (115th Congress), Illinois",1,17,1701,Congressional District 1,Illinois,5001500US1701,710088,364358,-0.4868833159,-345730,0.5131166841
1702,570,39309,45727,0.1632704979,6418,"Congressional District 2 (115th Congress), Illinois",2,17,1702,Congressional District 2,Illinois,5001500US1702,704139,396777,-0.4365075646,-307362,0.5634924354
1703,571,44862,63055,0.405532522,18193,"Congressional District 3 (115th Congress), Illinois",3,17,1703,Congressional District 3,Illinois,5001500US1703,722176,34522,-0.9521972483,-687654,0.04780275168
1704,572,36429,46557,0.2780202586,10128,"Congressional District 4 (115th Congress), Illinois",4,17,1704,Congressional District 4,Illinois,5001500US1704,702322,30716,-0.956265075,-671606,0.04373492501
1705,573,46149,74066,0.6049318512,27917,"Congressional District 5 (115th Congress), Illinois",5,17,1705,Congressional District 5,Illinois,5001500US1705,732035,20714,-0.9717035388,-711321,0.02829646123
1706,574,55064,93839,0.7041805899,38775,"Congressional District 6 (115th Congress), Illinois",6,17,1706,Congressional District 6,Illinois,5001500US1706,724601,19049,-0.9737110493,-705552,0.02628895075
1707,575,28844,51546,0.7870614339,22702,"Congressional District 7 (115th Congress), Illinois",7,17,1707,Congressional District 7,Illinois,5001500US1707,728896,360859,-0.5049238849,-368037,0.4950761151
1708,576,46057,66407,0.4418438022,20350,"Congressional District 8 (115th Congress), Illinois",8,17,1708,Congressional District 8,Illinois,5001500US1708,716964,33817,-0.9528330572,-683147,0.04716694283
1709,577,32376,65764,1.031257722,33388,"Congressional District 9 (115th Congress), Illinois",9,17,1709,Congressional District 9,Illinois,5001500US1709,718764,64402,-0.9103989627,-654362,0.08960103734
1710,578,39936,74233,0.8587990785,34297,"Congressional District 10 (115th Congress), Illinois",10,17,1710,Congressional District 10,Illinois,5001500US1710,713713,47856,-0.9329478376,-665857,0.06705216242
1711,579,49400,69355,0.4039473684,19955,"Congressional District 11 (115th Congress), Illinois",11,17,1711,Congressional District 11,Illinois,5001500US1711,722749,80084,-0.8891952808,-642665,0.1108047192
1712,580,25998,45874,0.7645203477,19876,"Congressional District 12 (115th Congress), Illinois",12,17,1712,Congressional District 12,Illinois,5001500US1712,703346,118022,-0.8321992305,-585324,0.1678007695
1713,581,27056,49031,0.812204317,21975,"Congressional District 13 (115th Congress), Illinois",13,17,1713,Congressional District 13,Illinois,5001500US1713,709735,80024,-0.8872480574,-629711,0.1127519426
1714,582,91209,86449,-0.05218783234,-4760,"Congressional District 14 (115th Congress), Illinois",14,17,1714,Congressional District 14,Illinois,5001500US1714,725478,23128,-0.9681203289,-702350,0.03187967106
1715,583,26357,49127,0.8639071214,22770,"Congressional District 15 (115th Congress), Illinois",15,17,1715,Congressional District 15,Illinois,5001500US1715,703108,30023,-0.9572995898,-673085,0.04270041018
1716,584,36456,56042,0.537250384,19586,"Congressional District 16 (115th Congress), Illinois",16,17,1716,Congressional District 16,Illinois,5001500US1716,700934,26665,-0.9619579019,-674269,0.03804209811
1717,585,25364,45144,0.7798454502,19780,"Congressional District 17 (115th Congress), Illinois",17,17,1717,Congressional District 17,Illinois,5001500US1717,698800,80044,-0.8854550658,-618756,0.1145449342
1718,586,33904,60947,0.7976344974,27043,"Congressional District 18 (115th Congress), Illinois",18,17,1718,Congressional District 18,Illinois,5001500US1718,713836,26552,-0.9628037813,-687284,0.03719621874
1801,587,32170,53183,0.6531861983,21013,"Congressional District 1 (115th Congress), Indiana",1,18,1801,Congressional District 1,Indiana,5001500US1801,717042,138010,-0.8075287082,-579032,0.1924712918
1802,588,24674,48073,0.9483261733,23399,"Congressional District 2 (115th Congress), Indiana",2,18,1802,Congressional District 2,Indiana,5001500US1802,721461,49550,-0.9313199189,-671911,0.06868008111
1803,589,26942,50277,0.8661198129,23335,"Congressional District 3 (115th Congress), Indiana",3,18,1803,Congressional District 3,Indiana,5001500US1803,733725,44199,-0.9397608096,-689526,0.06023919043
1804,590,37293,53333,0.4301075269,16040,"Congressional District 4 (115th Congress), Indiana",4,18,1804,Congressional District 4,Indiana,5001500US1804,741149,27743,-0.9625675809,-713406,0.03743241912
1805,591,41573,64754,0.5575974791,23181,"Congressional District 5 (115th Congress), Indiana",5,18,1805,Congressional District 5,Indiana,5001500US1805,749284,60603,-0.9191187854,-688681,0.0808812146
1806,592,31976,48554,0.5184513385,16578,"Congressional District 6 (115th Congress), Indiana",6,18,1806,Congressional District 6,Indiana,5001500US1806,719078,18061,-0.9748831142,-701017,0.02511688579
1807,593,29633,39917,0.3470455236,10284,"Congressional District 7 (115th Congress), Indiana",7,18,1807,Congressional District 7,Indiana,5001500US1807,747290,220637,-0.7047504985,-526653,0.2952495015
1808,594,25559,47444,0.856254157,21885,"Congressional District 8 (115th Congress), Indiana",8,18,1808,Congressional District 8,Indiana,5001500US1808,721951,28987,-0.9598490756,-692964,0.04015092437
1809,595,40631,51881,0.2768821836,11250,"Congressional District 9 (115th Congress), Indiana",9,18,1809,Congressional District 9,Indiana,5001500US1809,738598,20436,-0.9723313629,-718162,0.02766863707
1901,596,26432,55366,1.09465799,28934,"Congressional District 1 (115th Congress), Iowa",1,19,1901,Congressional District 1,Iowa,5001500US1901,769896,27355,-0.964469227,-742541,0.03553077299
1902,597,30417,52126,0.7137127264,21709,"Congressional District 2 (115th Congress), Iowa",2,19,1902,Congressional District 2,Iowa,5001500US1902,775699,31264,-0.9596957067,-744435,0.04030429329
1903,598,31997,60261,0.8833328125,28264,"Congressional District 3 (115th Congress), Iowa",3,19,1903,Congressional District 3,Iowa,5001500US1903,801132,32712,-0.9591677776,-768420,0.04083222241
1904,599,27454,51111,0.8616959277,23657,"Congressional District 4 (115th Congress), Iowa",4,19,1904,Congressional District 4,Iowa,5001500US1904,759862,11721,-0.9845748307,-748141,0.01542516931
2001,600,40285,48205,0.1965992305,7920,"Congressional District 1 (115th Congress), Kansas",1,20,2001,Congressional District 1,Kansas,5001500US2001,716382,21833,-0.9695232432,-694549,0.03047675681
2002,601,31544,50431,0.5987509511,18887,"Congressional District 2 (115th Congress), Kansas",2,20,2002,Congressional District 2,Kansas,5001500US2002,714490,31716,-0.9556102955,-682774,0.04438970454
2003,602,37450,68548,0.8303871829,31098,"Congressional District 3 (115th Congress), Kansas",3,20,2003,Congressional District 3,Kansas,5001500US2003,746158,64218,-0.9139351183,-681940,0.0860648817
2004,603,29276,51260,0.7509222571,21984,"Congressional District 4 (115th Congress), Kansas",4,20,2004,Congressional District 4,Kansas,5001500US2004,721262,49939,-0.9307616372,-671323,0.06923836276
2101,604,26381,39757,0.5070315758,13376,"Congressional District 1 (115th Congress), Kentucky",1,21,2101,Congressional District 1,Kentucky,5001500US2101,723571,50795,-0.9297995636,-672776,0.07020043645
2102,605,36271,47051,0.2972071352,10780,"Congressional District 2 (115th Congress), Kentucky",2,21,2102,Congressional District 2,Kentucky,5001500US2102,743449,40712,-0.9452390144,-702737,0.05476098562
2103,606,30361,49070,0.6162181746,18709,"Congressional District 3 (115th Congress), Kentucky",3,21,2103,Congressional District 3,Kentucky,5001500US2103,739212,158149,-0.7860573151,-581063,0.2139426849
2104,607,34644,57084,0.6477312089,22440,"Congressional District 4 (115th Congress), Kentucky",4,21,2104,Congressional District 4,Kentucky,5001500US2104,743503,24908,-0.9664991264,-718595,0.03350087357
2105,608,25437,31274,0.2294688839,5837,"Congressional District 5 (115th Congress), Kentucky",5,21,2105,Congressional District 5,Kentucky,5001500US2105,711115,10243,-0.98559586,-700872,0.01440413998
2106,609,30177,48170,0.5962487988,17993,"Congressional District 6 (115th Congress), Kentucky",6,21,2106,Congressional District 6,Kentucky,5001500US2106,751139,65435,-0.912885631,-685704,0.08711436898
2201,610,33315,55997,0.680834459,22682,"Congressional District 1 (115th Congress), Louisiana",1,22,2201,Congressional District 1,Louisiana,5001500US2201,792297,105721,-0.8665639274,-686576,0.1334360726
2202,611,28486,37096,0.3022537387,8610,"Congressional District 2 (115th Congress), Louisiana",2,22,2202,Congressional District 2,Louisiana,5001500US2202,779918,485145,-0.3779538362,-294773,0.6220461638
2203,612,28287,47016,0.6621062679,18729,"Congressional District 3 (115th Congress), Louisiana",3,22,2203,Congressional District 3,Louisiana,5001500US2203,775987,189645,-0.7556080192,-586342,0.2443919808
2204,613,25759,41240,0.6009938274,15481,"Congressional District 4 (115th Congress), Louisiana",4,22,2204,Congressional District 4,Louisiana,5001500US2204,759843,258522,-0.6597691892,-501321,0.3402308108
2205,614,21698,35968,0.6576643009,14270,"Congressional District 5 (115th Congress), Louisiana",5,22,2205,Congressional District 5,Louisiana,5001500US2205,752483,267023,-0.6451441428,-485460,0.3548558572
2206,615,41643,58628,0.4078716711,16985,"Congressional District 6 (115th Congress), Louisiana",6,22,2206,Congressional District 6,Louisiana,5001500US2206,785142,188145,-0.7603681882,-596997,0.2396318118
2301,616,27886,57209,1.051531234,29323,"Congressional District 1 (115th Congress), Maine",1,23,2301,Congressional District 1,Maine,5001500US2301,673137,11046,-0.9835902647,-662091,0.01640973531
2302,617,27478,44649,0.6248999199,17171,"Congressional District 2 (115th Congress), Maine",2,23,2302,Congressional District 2,Maine,5001500US2302,656786,5257,-0.9919958708,-651529,0.008004129199
2401,618,39564,69650,0.7604387827,30086,"Congressional District 1 (115th Congress), Maryland",1,24,2401,Congressional District 1,Maryland,5001500US2401,728394,86613,-0.8810904538,-641781,0.1189095462
2402,619,57206,63876,0.1165961612,6670,"Congressional District 2 (115th Congress), Maryland",2,24,2402,Congressional District 2,Maryland,5001500US2402,751657,253802,-0.6623433295,-497855,0.3376566705
2403,620,61206,81032,0.3239224913,19826,"Congressional District 3 (115th Congress), Maryland",3,24,2403,Congressional District 3,Maryland,5001500US2403,747023,162725,-0.7821686882,-584298,0.2178313118
2404,621,69992,76776,0.0969253629,6784,"Congressional District 4 (115th Congress), Maryland",4,24,2404,Congressional District 4,Maryland,5001500US2404,741905,392546,-0.4708945215,-349359,0.5291054785
2405,622,89489,92295,0.03135580909,2806,"Congressional District 5 (115th Congress), Maryland",5,24,2405,Congressional District 5,Maryland,5001500US2405,753865,286180,-0.6203829598,-467685,0.3796170402
2406,623,62682,74892,0.1947927635,12210,"Congressional District 6 (115th Congress), Maryland",6,24,2406,Congressional District 6,Maryland,5001500US2406,755153,101731,-0.8652842537,-653422,0.1347157463
2407,624,40866,58128,0.4224049332,17262,"Congressional District 7 (115th Congress), Maryland",7,24,2407,Congressional District 7,Maryland,5001500US2407,727420,391364,-0.4619834484,-336056,0.5380165516
2408,625,66896,97663,0.4599228653,30767,"Congressional District 8 (115th Congress), Maryland",8,24,2408,Congressional District 8,Maryland,5001500US2408,754485,90965,-0.8794343161,-663520,0.1205656839
2501,626,36622,53667,0.4654306155,17045,"Congressional District 1 (115th Congress), Massachusetts",1,25,2501,Congressional District 1,Massachusetts,5001500US2501,730824,45701,-0.9374664762,-685123,0.0625335238
2502,627,42039,64341,0.530507386,22302,"Congressional District 2 (115th Congress), Massachusetts",2,25,2502,Congressional District 2,Massachusetts,5001500US2502,740590,37837,-0.9489096531,-702753,0.05109034689
2503,628,49243,72039,0.4629287411,22796,"Congressional District 3 (115th Congress), Massachusetts",3,25,2503,Congressional District 3,Massachusetts,5001500US2503,754800,28049,-0.9628391627,-726751,0.03716083731
2504,629,63695,91203,0.4318706335,27508,"Congressional District 4 (115th Congress), Massachusetts",4,25,2504,Congressional District 4,Massachusetts,5001500US2504,747492,21596,-0.9711087209,-725896,0.0288912791
2505,630,58022,86416,0.4893661025,28394,"Congressional District 5 (115th Congress), Massachusetts",5,25,2505,Congressional District 5,Massachusetts,5001500US2505,753460,37294,-0.9505030128,-716166,0.04949698723
2506,631,51420,81711,0.5890898483,30291,"Congressional District 6 (115th Congress), Massachusetts",6,25,2506,Congressional District 6,Massachusetts,5001500US2506,755438,25191,-0.9666537823,-730247,0.03334621769
2507,632,40953,55508,0.3554074183,14555,"Congressional District 7 (115th Congress), Massachusetts",7,25,2507,Congressional District 7,Massachusetts,5001500US2507,768049,199757,-0.7399163335,-568292,0.2600836665
2508,633,51867,78995,0.5230300576,27128,"Congressional District 8 (115th Congress), Massachusetts",8,25,2508,Congressional District 8,Massachusetts,5001500US2508,756875,73481,-0.9029152766,-683394,0.09708472337
2509,634,37210,64092,0.7224402042,26882,"Congressional District 9 (115th Congress), Massachusetts",9,25,2509,Congressional District 9,Massachusetts,5001500US2509,734615,20327,-0.9723297237,-714288,0.02767027627
2601,635,31761,44864,0.4125499827,13103,"Congressional District 1 (115th Congress), Michigan",1,26,2601,Congressional District 1,Michigan,5001500US2601,702602,11353,-0.9838414921,-691249,0.01615850795
2602,636,26968,50916,0.8880154257,23948,"Congressional District 2 (115th Congress), Michigan",2,26,2602,Congressional District 2,Michigan,5001500US2602,724022,45343,-0.93737345,-678679,0.06262655002
2603,637,28089,53680,0.9110683898,25591,"Congressional District 3 (115th Congress), Michigan",3,26,2603,Congressional District 3,Michigan,5001500US2603,725581,62345,-0.9140757545,-663236,0.08592424554
2604,638,30257,46128,0.5245397759,15871,"Congressional District 4 (115th Congress), Michigan",4,26,2604,Congressional District 4,Michigan,5001500US2604,701884,12534,-0.9821423483,-689350,0.01785765169
2605,639,25474,42100,0.6526654628,16626,"Congressional District 5 (115th Congress), Michigan",5,26,2605,Congressional District 5,Michigan,5001500US2605,687000,119506,-0.8260465793,-567494,0.1739534207
2606,640,25951,49087,0.8915263381,23136,"Congressional District 6 (115th Congress), Michigan",6,26,2606,Congressional District 6,Michigan,5001500US2606,712805,59232,-0.9169029398,-653573,0.08309706021
2607,641,32098,54225,0.6893575924,22127,"Congressional District 7 (115th Congress), Michigan",7,26,2607,Congressional District 7,Michigan,5001500US2607,704160,30228,-0.9570722563,-673932,0.04292774369
2608,642,35428,65205,0.8404933951,29777,"Congressional District 8 (115th Congress), Michigan",8,26,2608,Congressional District 8,Michigan,5001500US2608,723429,39678,-0.9451528761,-683751,0.05484712391
2609,643,35004,52684,0.5050851331,17680,"Congressional District 9 (115th Congress), Michigan",9,26,2609,Congressional District 9,Michigan,5001500US2609,715955,89331,-0.8752281917,-626624,0.1247718083
2610,644,55000,58557,0.06467272727,3557,"Congressional District 10 (115th Congress), Michigan",10,26,2610,Congressional District 10,Michigan,5001500US2610,711809,20132,-0.971717132,-691677,0.02828286802
2611,645,53670,76851,0.4319172722,23181,"Congressional District 11 (115th Congress), Michigan",11,26,2611,Congressional District 11,Michigan,5001500US2611,717277,37160,-0.9481929575,-680117,0.05180704247
2612,646,36343,53815,0.4807528272,17472,"Congressional District 12 (115th Congress), Michigan",12,26,2612,Congressional District 12,Michigan,5001500US2612,705980,75378,-0.89322927,-630602,0.10677073
2613,647,25590,32076,0.2534583822,6486,"Congressional District 13 (115th Congress), Michigan",13,26,2613,Congressional District 13,Michigan,5001500US2613,684837,380465,-0.4444444444,-304372,0.5555555556
2614,648,33543,42167,0.2571028232,8624,"Congressional District 14 (115th Congress), Michigan",14,26,2614,Congressional District 14,Michigan,5001500US2614,692259,393761,-0.4311941051,-298498,0.5688058949
2701,649,26215,57780,1.204081633,31565,"Congressional District 1 (115th Congress), Minnesota",1,27,2701,Congressional District 1,Minnesota,5001500US2701,668498,19015,-0.9715556367,-649483,0.02844436333
2702,650,49333,77468,0.5703079075,28135,"Congressional District 2 (115th Congress), Minnesota",2,27,2702,Congressional District 2,Minnesota,5001500US2702,686967,28747,-0.9581537396,-658220,0.04184626045
2703,651,40544,81804,1.017659826,41260,"Congressional District 3 (115th Congress), Minnesota",3,27,2703,Congressional District 3,Minnesota,5001500US2703,695383,48810,-0.9298084653,-646573,0.07019153474
2704,652,30750,63826,1.075642276,33076,"Congressional District 4 (115th Congress), Minnesota",4,27,2704,Congressional District 4,Minnesota,5001500US2704,693301,67272,-0.9029685519,-626029,0.0970314481
2705,653,24966,55396,1.218857646,30430,"Congressional District 5 (115th Congress), Minnesota",5,27,2705,Congressional District 5,Minnesota,5001500US2705,693188,115043,-0.8340378079,-578145,0.1659621921
2706,654,34250,73884,1.15719708,39634,"Congressional District 6 (115th Congress), Minnesota",6,27,2706,Congressional District 6,Minnesota,5001500US2706,687421,17753,-0.974174487,-669668,0.02582551304
2707,655,20274,52930,1.610732958,32656,"Congressional District 7 (115th Congress), Minnesota",7,27,2707,Congressional District 7,Minnesota,5001500US2707,663338,7332,-0.9889468114,-656006,0.01105318857
2708,656,19398,51684,1.664398392,32286,"Congressional District 8 (115th Congress), Minnesota",8,27,2708,Congressional District 8,Minnesota,5001500US2708,662772,6881,-0.9896178475,-655891,0.01038215254
2801,657,30235,42647,0.410517612,12412,"Congressional District 1 (115th Congress), Mississippi",1,28,2801,Congressional District 1,Mississippi,5001500US2801,755945,205742,-0.727834697,-550203,0.272165303
2802,658,25859,32409,0.2532967245,6550,"Congressional District 2 (115th Congress), Mississippi",2,28,2802,Congressional District 2,Mississippi,5001500US2802,723747,474859,-0.3438881267,-248888,0.6561118733
2803,659,27971,42767,0.5289764399,14796,"Congressional District 3 (115th Congress), Mississippi",3,28,2803,Congressional District 3,Mississippi,5001500US2803,748787,262921,-0.6488707737,-485866,0.3511292263
2804,660,26613,43173,0.6222522827,16560,"Congressional District 4 (115th Congress), Mississippi",4,28,2804,Congressional District 4,Mississippi,5001500US2804,760713,177805,-0.7662653327,-582908,0.2337346673
2901,661,32105,41817,0.3025073976,9712,"Congressional District 1 (115th Congress), Missouri",1,29,2901,Congressional District 1,Missouri,5001500US2901,740262,365921,-0.5056871756,-374341,0.4943128244
2902,662,54353,76996,0.4165915405,22643,"Congressional District 2 (115th Congress), Missouri",2,29,2902,Congressional District 2,Missouri,5001500US2902,760782,28455,-0.9625976955,-732327,0.03740230447
2903,663,37157,57658,0.5517399144,20501,"Congressional District 3 (115th Congress), Missouri",3,29,2903,Congressional District 3,Missouri,5001500US2903,768153,25244,-0.9671367553,-742909,0.03286324469
2904,664,34959,45929,0.3137961612,10970,"Congressional District 4 (115th Congress), Missouri",4,29,2904,Congressional District 4,Missouri,5001500US2904,761184,35105,-0.953881059,-726079,0.04611894102
2905,665,32355,45886,0.4182042961,13531,"Congressional District 5 (115th Congress), Missouri",5,29,2905,Congressional District 5,Missouri,5001500US2905,757531,166637,-0.7800261639,-590894,0.2199738361
2906,666,42854,55377,0.2922247631,12523,"Congressional District 6 (115th Congress), Missouri",6,29,2906,Congressional District 6,Missouri,5001500US2906,760050,31400,-0.9586869285,-728650,0.04131307151
2907,667,30033,42719,0.4224020244,12686,"Congressional District 7 (115th Congress), Missouri",7,29,2907,Congressional District 7,Missouri,5001500US2907,764936,14423,-0.9811448278,-750513,0.0188551722
2908,668,22467,39076,0.7392620288,16609,"Congressional District 8 (115th Congress), Missouri",8,29,2908,Congressional District 8,Missouri,5001500US2908,746753,34711,-0.9535174281,-712042,0.04648257188
3000,669,28863,48380,0.6761944358,19517,"Congressional District (at Large) (115th Congress), Montana",0,30,3000,Congressional District (at Large),Montana,5001500US3000,1023391,4260,-0.9958373681,-1019131,0.004162631878
3101,670,36378,55048,0.5132222772,18670,"Congressional District 1 (115th Congress), Nebraska",1,31,3101,Congressional District 1,Nebraska,5001500US3101,630685,18278,-0.9710188129,-612407,0.02898118712
3102,671,28758,59906,1.083107309,31148,"Congressional District 2 (115th Congress), Nebraska",2,31,3102,Congressional District 2,Nebraska,5001500US3102,643888,63081,-0.9020310986,-580807,0.09796890142
3103,672,29389,50034,0.7024737147,20645,"Congressional District 3 (115th Congress), Nebraska",3,31,3103,Congressional District 3,Nebraska,5001500US3103,606686,7029,-0.9884141055,-599657,0.01158589452
3201,673,27208,38941,0.4312334607,11733,"Congressional District 1 (115th Congress), Nevada",1,32,3201,Congressional District 1,Nevada,5001500US3201,685133,75178,-0.8902723997,-609955,0.1097276003
3202,674,37592,55692,0.4814854224,18100,"Congressional District 2 (115th Congress), Nevada",2,32,3202,Congressional District 2,Nevada,5001500US3202,696099,13097,-0.9811851475,-683002,0.01881485249
3203,675,50313,64740,0.2867449764,14427,"Congressional District 3 (115th Congress), Nevada",3,32,3203,Congressional District 3,Nevada,5001500US3203,739847,51716,-0.930099061,-688131,0.06990093898
3204,676,43217,53889,0.2469398616,10672,"Congressional District 4 (115th Congress), Nevada",4,32,3204,Congressional District 4,Nevada,5001500US3204,718093,103561,-0.8557833038,-614532,0.1442166962
3301,677,48173,69225,0.4370082826,21052,"Congressional District 1 (115th Congress), New Hampshire",1,33,3301,Congressional District 1,New Hampshire,5001500US3301,667330,9752,-0.9853865404,-657578,0.01461345961
3302,678,53536,67675,0.2641026599,14139,"Congressional District 2 (115th Congress), New Hampshire",2,33,3302,Congressional District 2,New Hampshire,5001500US3302,660173,7731,-0.9882894332,-652442,0.01171056678
3401,679,45208,65770,0.4548310034,20562,"Congressional District 1 (115th Congress), New Jersey",1,34,3401,Congressional District 1,New Jersey,5001500US3401,731077,127173,-0.8260470511,-603904,0.1739529489
3402,680,35219,59785,0.6975212243,24566,"Congressional District 2 (115th Congress), New Jersey",2,34,3402,Congressional District 2,New Jersey,5001500US3402,729824,93000,-0.8725720174,-636824,0.1274279826
3403,681,67452,74644,0.1066239696,7192,"Congressional District 3 (115th Congress), New Jersey",3,34,3403,Congressional District 3,New Jersey,5001500US3403,736722,78318,-0.8936939578,-658404,0.1063060422
3404,682,52337,77685,0.4843227545,25348,"Congressional District 4 (115th Congress), New Jersey",4,34,3404,Congressional District 4,New Jersey,5001500US3404,738951,48596,-0.9342365055,-690355,0.06576349447
3405,683,65535,95701,0.4603036545,30166,"Congressional District 5 (115th Congress), New Jersey",5,34,3405,Congressional District 5,New Jersey,5001500US3405,742080,38376,-0.9482858991,-703704,0.05171410091
3406,684,58825,77157,0.3116362091,18332,"Congressional District 6 (115th Congress), New Jersey",6,34,3406,Congressional District 6,New Jersey,5001500US3406,743100,75479,-0.8984268604,-667621,0.1015731396
3407,685,75110,104987,0.3977765943,29877,"Congressional District 7 (115th Congress), New Jersey",7,34,3407,Congressional District 7,New Jersey,5001500US3407,741497,33950,-0.954214245,-707547,0.04578575503
3408,686,41256,55493,0.3450891991,14237,"Congressional District 8 (115th Congress), New Jersey",8,34,3408,Congressional District 8,New Jersey,5001500US3408,766386,80692,-0.8947110203,-685694,0.1052889797
3409,687,42155,62559,0.4840232475,20404,"Congressional District 9 (115th Congress), New Jersey",9,34,3409,Congressional District 9,New Jersey,5001500US3409,751662,80773,-0.8925407963,-670889,0.1074592037
3410,688,40306,48168,0.1950578078,7862,"Congressional District 10 (115th Congress), New Jersey",10,34,3410,Congressional District 10,New Jersey,5001500US3410,741960,391212,-0.4727316836,-350748,0.5272683164
3411,689,81070,103419,0.2756753423,22349,"Congressional District 11 (115th Congress), New Jersey",11,34,3411,Congressional District 11,New Jersey,5001500US3411,740727,27655,-0.9626650574,-713072,0.03733494256
3412,690,53182,81115,0.5252341018,27933,"Congressional District 12 (115th Congress), New Jersey",12,34,3412,Congressional District 12,New Jersey,5001500US3412,751470,131997,-0.8243482774,-619473,0.1756517226
3501,691,39658,47990,0.2100963236,8332,"Congressional District 1 (115th Congress), New Mexico",1,35,3501,Congressional District 1,New Mexico,5001500US3501,692610,19068,-0.972469355,-673542,0.02753064495
3502,692,42209,41600,-0.01442820252,-609,"Congressional District 2 (115th Congress), New Mexico",2,35,3502,Congressional District 2,New Mexico,5001500US3502,698524,12239,-0.9824787695,-686285,0.01752123048
3503,693,43735,47956,0.0965130902,4221,"Congressional District 3 (115th Congress), New Mexico",3,35,3503,Congressional District 3,New Mexico,5001500US3503,691535,10650,-0.984599478,-680885,0.01540052203
3601,694,50820,88242,0.7363636364,37422,"Congressional District 1 (115th Congress), New York",1,36,3601,Congressional District 1,New York,5001500US3601,722038,36208,-0.9498530548,-685830,0.05014694517
3602,695,75895,90614,0.1939389947,14719,"Congressional District 2 (115th Congress), New York",2,36,3602,Congressional District 2,New York,5001500US3602,720950,72296,-0.8997212012,-648654,0.1002787988
3603,696,80111,104805,0.3082473069,24694,"Congressional District 3 (115th Congress), New York",3,36,3603,Congressional District 3,New York,5001500US3603,724563,22430,-0.9690434096,-702133,0.03095659039
3604,697,81304,96078,0.1817130768,14774,"Congressional District 4 (115th Congress), New York",4,36,3604,Congressional District 4,New York,5001500US3604,722016,104994,-0.8545821699,-617022,0.1454178301
3605,698,65603,62979,-0.03999817082,-2624,"Congressional District 5 (115th Congress), New York",5,36,3605,Congressional District 5,New York,5001500US3605,774752,383533,-0.504960297,-391219,0.495039703
3606,699,61696,60158,-0.02492868257,-1538,"Congressional District 6 (115th Congress), New York",6,36,3606,Congressional District 6,New York,5001500US3606,730534,28787,-0.9605945788,-701747,0.03940542124
3607,700,34857,49581,0.4224115673,14724,"Congressional District 7 (115th Congress), New York",7,36,3607,Congressional District 7,New York,5001500US3607,748294,83754,-0.8880734043,-664540,0.1119265957
3608,701,43735,47048,0.07575168629,3313,"Congressional District 8 (115th Congress), New York",8,36,3608,Congressional District 8,New York,5001500US3608,753062,414064,-0.4501594822,-338998,0.5498405178
3609,702,41691,50825,0.2190880526,9134,"Congressional District 9 (115th Congress), New York",9,36,3609,Congressional District 9,New York,5001500US3609,742131,374714,-0.4950837521,-367417,0.5049162479
3610,703,44487,81814,0.8390541057,37327,"Congressional District 10 (115th Congress), New York",10,36,3610,Congressional District 10,New York,5001500US3610,731073,29362,-0.9598371161,-701711,0.04016288387
3611,704,45158,66890,0.4812436335,21732,"Congressional District 11 (115th Congress), New York",11,36,3611,Congressional District 11,New York,5001500US3611,729159,55017,-0.924547321,-674142,0.07545267905
3612,705,37569,93559,1.49032447,55990,"Congressional District 12 (115th Congress), New York",12,36,3612,Congressional District 12,New York,5001500US3612,725977,36066,-0.9503207402,-689911,0.04967925981
3613,706,33591,37263,0.1093149951,3672,"Congressional District 13 (115th Congress), New York",13,36,3613,Congressional District 13,New York,5001500US3613,768090,230237,-0.7002473668,-537853,0.2997526332
3614,707,52201,52427,0.004329418977,226,"Congressional District 14 (115th Congress), New York",14,36,3614,Congressional District 14,New York,5001500US3614,722309,79510,-0.889922457,-642799,0.110077543
3615,708,29579,26096,-0.1177524595,-3483,"Congressional District 15 (115th Congress), New York",15,36,3615,Congressional District 15,New York,5001500US3615,747882,242173,-0.6761882222,-505709,0.3238117778
3616,709,52043,66153,0.2711219568,14110,"Congressional District 16 (115th Congress), New York",16,36,3616,Congressional District 16,New York,5001500US3616,738787,241558,-0.6730343116,-497229,0.3269656884
3617,710,69029,91734,0.3289197294,22705,"Congressional District 17 (115th Congress), New York",17,36,3617,Congressional District 17,New York,5001500US3617,738467,79026,-0.8929864165,-659441,0.1070135835
3618,711,55307,79539,0.4381362215,24232,"Congressional District 18 (115th Congress), New York",18,36,3618,Congressional District 18,New York,5001500US3618,721184,68153,-0.9054984581,-653031,0.09450154191
3619,712,37919,58698,0.5479838603,20779,"Congressional District 19 (115th Congress), New York",19,36,3619,Congressional District 19,New York,5001500US3619,707053,31501,-0.95544747,-675552,0.04455253001
3620,713,31317,62112,0.9833317368,30795,"Congressional District 20 (115th Congress), New York",20,36,3620,Congressional District 20,New York,5001500US3620,725336,66653,-0.908107415,-658683,0.09189258495
3621,714,46743,51976,0.1119525918,5233,"Congressional District 21 (115th Congress), New York",21,36,3621,Congressional District 21,New York,5001500US3621,715390,22230,-0.9689260403,-693160,0.03107395966
3622,715,25678,50059,0.9494898357,24381,"Congressional District 22 (115th Congress), New York",22,36,3622,Congressional District 22,New York,5001500US3622,708362,28821,-0.959313176,-679541,0.04068682397
3623,716,25213,47916,0.9004481815,22703,"Congressional District 23 (115th Congress), New York",23,36,3623,Congressional District 23,New York,5001500US3623,709936,20651,-0.9709114624,-689285,0.02908853756
3624,717,28741,53930,0.876413486,25189,"Congressional District 24 (115th Congress), New York",24,36,3624,Congressional District 24,New York,5001500US3624,713917,59259,-0.9169945526,-654658,0.08300544741
3625,718,28487,53060,0.8626039948,24573,"Congressional District 25 (115th Congress), New York",25,36,3625,Congressional District 25,New York,5001500US3625,722212,113898,-0.8422928448,-608314,0.1577071552
3626,719,26503,45640,0.7220691997,19137,"Congressional District 26 (115th Congress), New York",26,36,3626,Congressional District 26,New York,5001500US3626,714792,130194,-0.8178575026,-584598,0.1821424974
3627,720,35371,61359,0.7347261881,25988,"Congressional District 27 (115th Congress), New York",27,36,3627,Congressional District 27,New York,5001500US3627,719191,18189,-0.9747090828,-701002,0.02529091716
3701,721,30454,40587,0.3327313325,10133,"Congressional District 1 (115th Congress), North Carolina",1,37,3701,Congressional District 1,North Carolina,5001500US3701,745646,333783,-0.5523572848,-411863,0.4476427152
3702,722,40521,61538,0.518669332,21017,"Congressional District 2 (115th Congress), North Carolina",2,37,3702,Congressional District 2,North Carolina,5001500US3702,791508,155502,-0.8035370457,-636006,0.1964629543
3703,723,31930,46916,0.4693391795,14986,"Congressional District 3 (115th Congress), North Carolina",3,37,3703,Congressional District 3,North Carolina,5001500US3703,749072,155066,-0.792989192,-594006,0.207010808
3704,724,44700,64252,0.4374049217,19552,"Congressional District 4 (115th Congress), North Carolina",4,37,3704,Congressional District 4,North Carolina,5001500US3704,806437,181504,-0.7749309617,-624933,0.2250690383
3705,725,30749,42087,0.3687274383,11338,"Congressional District 5 (115th Congress), North Carolina",5,37,3705,Congressional District 5,North Carolina,5001500US3705,745704,108229,-0.8548633238,-637475,0.1451366762
3706,726,32523,45391,0.3956584571,12868,"Congressional District 6 (115th Congress), North Carolina",6,37,3706,Congressional District 6,North Carolina,5001500US3706,754902,150812,-0.8002230753,-604090,0.1997769247
3707,727,27615,44413,0.6082925946,16798,"Congressional District 7 (115th Congress), North Carolina",7,37,3707,Congressional District 7,North Carolina,5001500US3707,768409,150115,-0.8046417988,-618294,0.1953582012
3708,728,37074,48643,0.3120515725,11569,"Congressional District 8 (115th Congress), North Carolina",8,37,3708,Congressional District 8,North Carolina,5001500US3708,760680,172502,-0.7732265867,-588178,0.2267734133
3709,729,31104,53630,0.724215535,22526,"Congressional District 9 (115th Congress), North Carolina",9,37,3709,Congressional District 9,North Carolina,5001500US3709,763890,149222,-0.8046551205,-614668,0.1953448795
3710,730,28448,43877,0.5423579865,15429,"Congressional District 10 (115th Congress), North Carolina",10,37,3710,Congressional District 10,North Carolina,5001500US3710,743721,89368,-0.8798366592,-654353,0.1201633408
3711,731,27188,41913,0.541599235,14725,"Congressional District 11 (115th Congress), North Carolina",11,37,3711,Congressional District 11,North Carolina,5001500US3711,743349,24326,-0.9672751292,-719023,0.03272487082
3712,732,40044,53409,0.3337578663,13365,"Congressional District 12 (115th Congress), North Carolina",12,37,3712,Congressional District 12,North Carolina,5001500US3712,811813,300673,-0.6296277591,-511140,0.3703722409
3713,733,32107,46792,0.457376896,14685,"Congressional District 13 (115th Congress), North Carolina",13,37,3713,Congressional District 13,North Carolina,5001500US3713,755697,166029,-0.780296865,-589668,0.219703135
3800,734,28474,59114,1.076069397,30640,"Congressional District (at Large) (115th Congress), North Dakota",0,38,3800,Congressional District (at Large),North Dakota,5001500US3800,736162,14761,-0.9799487069,-721401,0.02005129306
3901,735,25402,53393,1.101921109,27991,"Congressional District 1 (115th Congress), Ohio",1,39,3901,Congressional District 1,Ohio,5001500US3901,730363,160385,-0.7804037171,-569978,0.2195962829
3902,736,32755,52629,0.6067470615,19874,"Congressional District 2 (115th Congress), Ohio",2,39,3902,Congressional District 2,Ohio,5001500US3902,724850,61843,-0.9146816583,-663007,0.08531834173
3903,737,32679,42960,0.3146057101,10281,"Congressional District 3 (115th Congress), Ohio",3,39,3903,Congressional District 3,Ohio,5001500US3903,757872,248344,-0.6723140583,-509528,0.3276859417
3904,738,26030,49974,0.919861698,23944,"Congressional District 4 (115th Congress), Ohio",4,39,3904,Congressional District 4,Ohio,5001500US3904,712613,37216,-0.9477753002,-675397,0.0522246998
3905,739,36934,54480,0.475063627,17546,"Congressional District 5 (115th Congress), Ohio",5,39,3905,Congressional District 5,Ohio,5001500US3905,724865,20999,-0.9710304677,-703866,0.02896953226
3906,740,24676,44574,0.8063705625,19898,"Congressional District 6 (115th Congress), Ohio",6,39,3906,Congressional District 6,Ohio,5001500US3906,707254,15894,-0.9775271685,-691360,0.02247283154
3907,741,27299,50830,0.861972966,23531,"Congressional District 7 (115th Congress), Ohio",7,39,3907,Congressional District 7,Ohio,5001500US3907,723913,29170,-0.9597051027,-694743,0.04029489732
3908,742,34732,53561,0.5421225383,18829,"Congressional District 8 (115th Congress), Ohio",8,39,3908,Congressional District 8,Ohio,5001500US3908,724240,43179,-0.9403802607,-681061,0.05961973931
3909,743,24063,41179,0.7112995055,17116,"Congressional District 9 (115th Congress), Ohio",9,39,3909,Congressional District 9,Ohio,5001500US3909,712630,114939,-0.8387115333,-597691,0.1612884667
3910,744,29804,48257,0.6191450812,18453,"Congressional District 10 (115th Congress), Ohio",10,39,3910,Congressional District 10,Ohio,5001500US3910,721070,122276,-0.8304242307,-598794,0.1695757693
3911,745,26045,34673,0.3312727971,8628,"Congressional District 11 (115th Congress), Ohio",11,39,3911,Congressional District 11,Ohio,5001500US3911,700217,374795,-0.4647445006,-325422,0.5352554994
3912,746,49415,66774,0.3512900941,17359,"Congressional District 12 (115th Congress), Ohio",12,39,3912,Congressional District 12,Ohio,5001500US3912,753567,34431,-0.9543093049,-719136,0.04569069505
3913,747,24305,42373,0.7433861345,18068,"Congressional District 13 (115th Congress), Ohio",13,39,3913,Congressional District 13,Ohio,5001500US3913,711936,82516,-0.8840963233,-629420,0.1159036767
3914,748,46738,62811,0.3438957593,16073,"Congressional District 14 (115th Congress), Ohio",14,39,3914,Congressional District 14,Ohio,5001500US3914,718097,31372,-0.9563123088,-686725,0.04368769122
3915,749,51358,57874,0.1268740995,6516,"Congressional District 15 (115th Congress), Ohio",15,39,3915,Congressional District 15,Ohio,5001500US3915,741447,28539,-0.9615090492,-712908,0.0384909508
3916,750,48570,62293,0.282540663,13723,"Congressional District 16 (115th Congress), Ohio",16,39,3916,Congressional District 16,Ohio,5001500US3916,722007,16045,-0.9777772238,-705962,0.02222277623
4001,751,28632,51527,0.7996297849,22895,"Congressional District 1 (115th Congress), Oklahoma",1,40,4001,Congressional District 1,Oklahoma,5001500US4001,781427,66904,-0.9143822776,-714523,0.08561772245
4002,752,25952,40205,0.5492062269,14253,"Congressional District 2 (115th Congress), Oklahoma",2,40,4002,Congressional District 2,Oklahoma,5001500US4002,748897,26300,-0.964881686,-722597,0.035118314
4003,753,31779,49178,0.5474999213,17399,"Congressional District 3 (115th Congress), Oklahoma",3,40,4003,Congressional District 3,Oklahoma,5001500US4003,772392,27978,-0.9637774601,-744414,0.03622253985
4004,754,39250,52339,0.333477707,13089,"Congressional District 4 (115th Congress), Oklahoma",4,40,4004,Congressional District 4,Oklahoma,5001500US4004,777882,52450,-0.9325733209,-725432,0.06742667911
4005,755,31059,47442,0.5274799575,16383,"Congressional District 5 (115th Congress), Oklahoma",5,40,4005,Congressional District 5,Oklahoma,5001500US4005,794991,107663,-0.8645733096,-687328,0.1354266904
4101,756,53152,66106,0.2437161349,12954,"Congressional District 1 (115th Congress), Oregon",1,41,4101,Congressional District 1,Oregon,5001500US4101,807470,12797,-0.9841517332,-794673,0.01584826681
4102,757,23073,46384,1.010315087,23311,"Congressional District 2 (115th Congress), Oregon",2,41,4102,Congressional District 2,Oregon,5001500US4102,788709,4862,-0.9938354957,-783847,0.006164504272
4103,758,27473,57649,1.098387508,30176,"Congressional District 3 (115th Congress), Oregon",3,41,4103,Congressional District 3,Oregon,5001500US4103,811147,41782,-0.9484902243,-769365,0.05150977566
4104,759,26505,44180,0.6668553103,17675,"Congressional District 4 (115th Congress), Oregon",4,41,4104,Congressional District 4,Oregon,5001500US4104,779056,6648,-0.9914665955,-772408,0.008533404531
4105,760,43233,56481,0.3064325862,13248,"Congressional District 5 (115th Congress), Oregon",5,41,4105,Congressional District 5,Oregon,5001500US4105,795885,7923,-0.9900450442,-787962,0.009954955804
4201,761,34648,42667,0.2314419303,8019,"Congressional District 1 (115th Congress), Pennsylvania",1,42,4201,Congressional District 1,Pennsylvania,5001500US4201,718736,256862,-0.6426198215,-461874,0.3573801785
4202,762,28519,38637,0.3547810232,10118,"Congressional District 2 (115th Congress), Pennsylvania",2,42,4202,Congressional District 2,Pennsylvania,5001500US4202,712388,413788,-0.4191536073,-298600,0.5808463927
4203,763,25463,49130,0.9294662844,23667,"Congressional District 3 (115th Congress), Pennsylvania",3,42,4203,Congressional District 3,Pennsylvania,5001500US4203,697809,32453,-0.9534930045,-665356,0.04650699547
4204,764,35532,59226,0.6668355285,23694,"Congressional District 4 (115th Congress), Pennsylvania",4,42,4204,Congressional District 4,Pennsylvania,5001500US4204,717233,56307,-0.9214941309,-660926,0.07850586908
4205,765,31250,47533,0.521056,16283,"Congressional District 5 (115th Congress), Pennsylvania",5,42,4205,Congressional District 5,Pennsylvania,5001500US4205,705575,17788,-0.9747893562,-687787,0.0252106438
4206,766,55319,77580,0.402411468,22261,"Congressional District 6 (115th Congress), Pennsylvania",6,42,4206,Congressional District 6,Pennsylvania,5001500US4206,722755,30785,-0.9574060366,-691970,0.04259396338
4207,767,55960,82483,0.4739635454,26523,"Congressional District 7 (115th Congress), Pennsylvania",7,42,4207,Congressional District 7,Pennsylvania,5001500US4207,717691,40227,-0.9439494156,-677464,0.05605058444
4208,768,49503,79615,0.6082863665,30112,"Congressional District 8 (115th Congress), Pennsylvania",8,42,4208,Congressional District 8,Pennsylvania,5001500US4208,708465,27070,-0.9617906319,-681395,0.03820936814
4209,769,28889,46561,0.6117207242,17672,"Congressional District 9 (115th Congress), Pennsylvania",9,42,4209,Congressional District 9,Pennsylvania,5001500US4209,698749,19665,-0.971856847,-679084,0.02814315298
4210,770,41234,51517,0.2493815783,10283,"Congressional District 10 (115th Congress), Pennsylvania",10,42,4210,Congressional District 10,Pennsylvania,5001500US4210,701757,24463,-0.9651403549,-677294,0.03485964515
4211,771,40178,52531,0.3074568172,12353,"Congressional District 11 (115th Congress), Pennsylvania",11,42,4211,Congressional District 11,Pennsylvania,5001500US4211,706988,37429,-0.9470585074,-669559,0.05294149264
4212,772,33910,57825,0.705249189,23915,"Congressional District 12 (115th Congress), Pennsylvania",12,42,4212,Congressional District 12,Pennsylvania,5001500US4212,702324,22096,-0.9685387371,-680228,0.03146126289
4213,773,43493,57623,0.3248798657,14130,"Congressional District 13 (115th Congress), Pennsylvania",13,42,4213,Congressional District 13,Pennsylvania,5001500US4213,723656,139230,-0.8076019545,-584426,0.1923980455
4214,774,27688,43329,0.5649017625,15641,"Congressional District 14 (115th Congress), Pennsylvania",14,42,4214,Congressional District 14,Pennsylvania,5001500US4214,702800,151000,-0.7851451338,-551800,0.2148548662
4215,775,38835,60100,0.5475730655,21265,"Congressional District 15 (115th Congress), Pennsylvania",15,42,4215,Congressional District 15,Pennsylvania,5001500US4215,719408,35210,-0.9510569802,-684198,0.04894301982
4216,776,33962,55641,0.6383310759,21679,"Congressional District 16 (115th Congress), Pennsylvania",16,42,4216,Congressional District 16,Pennsylvania,5001500US4216,722007,47589,-0.9340878967,-674418,0.06591210335
4217,777,43199,49619,0.1486145513,6420,"Congressional District 17 (115th Congress), Pennsylvania",17,42,4217,Congressional District 17,Pennsylvania,5001500US4217,698821,42332,-0.9394236865,-656489,0.06057631353
4218,778,36027,62283,0.7287867433,26256,"Congressional District 18 (115th Congress), Pennsylvania",18,42,4218,Congressional District 18,Pennsylvania,5001500US4218,706815,16269,-0.9769826617,-690546,0.02301733834
4401,779,36419,53699,0.4744776078,17280,"Congressional District 1 (115th Congress), Rhode Island",1,44,4401,Congressional District 1,Rhode Island,5001500US4401,529708,47930,-0.9095161863,-481778,0.09048381372
4402,780,38580,63107,0.6357439088,24527,"Congressional District 2 (115th Congress), Rhode Island",2,44,4402,Congressional District 2,Rhode Island,5001500US4402,524783,20956,-0.960067304,-503827,0.03993269599
4501,781,37987,61354,0.6151314924,23367,"Congressional District 1 (115th Congress), South Carolina",1,45,4501,Congressional District 1,South Carolina,5001500US4501,731010,138612,-0.8103828949,-592398,0.1896171051
4502,782,41699,55143,0.3224058131,13444,"Congressional District 2 (115th Congress), South Carolina",2,45,4502,Congressional District 2,South Carolina,5001500US4502,689145,160845,-0.7666020939,-528300,0.2333979061
4503,783,28671,42513,0.4827874856,13842,"Congressional District 3 (115th Congress), South Carolina",3,45,4503,Congressional District 3,South Carolina,5001500US4503,672526,124650,-0.8146540059,-547876,0.1853459941
4504,784,30820,49093,0.5928942245,18273,"Congressional District 4 (115th Congress), South Carolina",4,45,4504,Congressional District 4,South Carolina,5001500US4504,697852,133388,-0.808859185,-564464,0.191140815
4505,785,30156,46062,0.5274572224,15906,"Congressional District 5 (115th Congress), South Carolina",5,45,4505,Congressional District 5,South Carolina,5001500US4505,687477,184296,-0.7319241226,-503181,0.2680758774
4506,786,28147,35014,0.2439691619,6867,"Congressional District 6 (115th Congress), South Carolina",6,45,4506,Congressional District 6,South Carolina,5001500US4506,667168,380034,-0.4303773562,-287134,0.5696226438
4507,787,27640,41296,0.4940665702,13656,"Congressional District 7 (115th Congress), South Carolina",7,45,4507,Congressional District 7,South Carolina,5001500US4507,689427,200543,-0.7091164112,-488884,0.2908835888
4600,788,35916,52078,0.4499944315,16162,"Congressional District (at Large) (115th Congress), South Dakota",0,46,4600,Congressional District (at Large),South Dakota,5001500US4600,851058,14078,-0.9834582367,-836980,0.01654176331
4701,789,26458,39305,0.4855620228,12847,"Congressional District 1 (115th Congress), Tennessee",1,47,4701,Congressional District 1,Tennessee,5001500US4701,711220,15709,-0.9779126009,-695511,0.02208739912
4702,790,28513,48615,0.705011749,20102,"Congressional District 2 (115th Congress), Tennessee",2,47,4702,Congressional District 2,Tennessee,5001500US4702,726682,45994,-0.9367068401,-680688,0.06329315987
4703,791,29506,43943,0.4892903138,14437,"Congressional District 3 (115th Congress), Tennessee",3,47,4703,Congressional District 3,Tennessee,5001500US4703,719834,78005,-0.891634738,-641829,0.108365262
4704,792,40111,48420,0.2071501583,8309,"Congressional District 4 (115th Congress), Tennessee",4,47,4704,Congressional District 4,Tennessee,5001500US4704,745636,62768,-0.9158195152,-682868,0.08418048485
4705,793,36010,50317,0.3973063038,14307,"Congressional District 5 (115th Congress), Tennessee",5,47,4705,Congressional District 5,Tennessee,5001500US4705,747388,186852,-0.74999331,-560536,0.25000669
4706,794,43287,47925,0.1071453323,4638,"Congressional District 6 (115th Congress), Tennessee",6,47,4706,Congressional District 6,Tennessee,5001500US4706,737895,31259,-0.9576376043,-706636,0.04236239573
4707,795,36666,51936,0.4164621175,15270,"Congressional District 7 (115th Congress), Tennessee",7,47,4707,Congressional District 7,Tennessee,5001500US4707,742791,73971,-0.9004147869,-668820,0.09958521307
4708,796,35025,53877,0.5382441113,18852,"Congressional District 8 (115th Congress), Tennessee",8,47,4708,Congressional District 8,Tennessee,5001500US4708,708571,140925,-0.801113791,-567646,0.198886209
4709,797,31793,37644,0.1840342214,5851,"Congressional District 9 (115th Congress), Tennessee",9,47,4709,Congressional District 9,Tennessee,5001500US4709,707992,465094,-0.3430801478,-242898,0.6569198522
4801,798,27562,45724,0.6589507293,18162,"Congressional District 1 (115th Congress), Texas",1,48,4801,Congressional District 1,Texas,5001500US4801,711851,125899,-0.8231385501,-585952,0.1768614499
4802,799,57353,74099,0.291981239,16746,"Congressional District 2 (115th Congress), Texas",2,48,4802,Congressional District 2,Texas,5001500US4802,758738,82727,-0.8909676331,-676011,0.1090323669
4803,800,64829,86783,0.3386447423,21954,"Congressional District 3 (115th Congress), Texas",3,48,4803,Congressional District 3,Texas,5001500US4803,791520,72355,-0.9085872751,-719165,0.09141272488
4804,801,27382,49540,0.8092177343,22158,"Congressional District 4 (115th Congress), Texas",4,48,4804,Congressional District 4,Texas,5001500US4804,721526,75729,-0.8950432833,-645797,0.1049567167
4805,802,36237,47410,0.3083312636,11173,"Congressional District 5 (115th Congress), Texas",5,48,4805,Congressional District 5,Texas,5001500US4805,731797,111125,-0.8481477787,-620672,0.1518522213
4806,803,52355,62450,0.19281826,10095,"Congressional District 6 (115th Congress), Texas",6,48,4806,Congressional District 6,Texas,5001500US4806,745202,147491,-0.8020791678,-597711,0.1979208322
4807,804,49127,71343,0.4522156859,22216,"Congressional District 7 (115th Congress), Texas",7,48,4807,Congressional District 7,Texas,5001500US4807,753088,98849,-0.8687417672,-654239,0.1312582328
4808,805,39114,64196,0.641253771,25082,"Congressional District 8 (115th Congress), Texas",8,48,4808,Congressional District 8,Texas,5001500US4808,782315,64223,-0.9179064699,-718092,0.0820935301
4809,806,42095,44024,0.04582491982,1929,"Congressional District 9 (115th Congress), Texas",9,48,4809,Congressional District 9,Texas,5001500US4809,762611,287960,-0.6224025093,-474651,0.3775974907
4810,807,50059,69430,0.3869633832,19371,"Congressional District 10 (115th Congress), Texas",10,48,4810,Congressional District 10,Texas,5001500US4810,783310,82961,-0.8940891856,-700349,0.1059108144
4811,808,37590,52461,0.3956105347,14871,"Congressional District 11 (115th Congress), Texas",11,48,4811,Congressional District 11,Texas,5001500US4811,744592,28352,-0.9619227711,-716240,0.03807722887
4812,809,43031,62081,0.442704097,19050,"Congressional District 12 (115th Congress), Texas",12,48,4812,Congressional District 12,Texas,5001500US4812,758403,63915,-0.9157242258,-694488,0.08427577423
4813,810,27434,49229,0.7944521397,21795,"Congressional District 13 (115th Congress), Texas",13,48,4813,Congressional District 13,Texas,5001500US4813,707120,38065,-0.9461689671,-669055,0.05383103292
4814,811,32721,55501,0.6961889918,22780,"Congressional District 14 (115th Congress), Texas",14,48,4814,Congressional District 14,Texas,5001500US4814,726919,144947,-0.8006008923,-581972,0.1993991077
4815,812,64232,41865,-0.34822207,-22367,"Congressional District 15 (115th Congress), Texas",15,48,4815,Congressional District 15,Texas,5001500US4815,753132,13811,-0.9816619132,-739321,0.01833808682
4816,813,47973,43683,-0.08942530173,-4290,"Congressional District 16 (115th Congress), Texas",16,48,4816,Congressional District 16,Texas,5001500US4816,732018,28712,-0.9607769208,-703306,0.03922307921
4817,814,33005,49401,0.4967732162,16396,"Congressional District 17 (115th Congress), Texas",17,48,4817,Congressional District 17,Texas,5001500US4817,738775,97772,-0.8676565937,-641003,0.1323434063
4818,815,32183,42352,0.3159742721,10169,"Congressional District 18 (115th Congress), Texas",18,48,4818,Congressional District 18,Texas,5001500US4818,749983,284630,-0.620484731,-465353,0.379515269
4819,816,31299,46727,0.4929230966,15428,"Congressional District 19 (115th Congress), Texas",19,48,4819,Congressional District 19,Texas,5001500US4819,718947,44506,-0.9380955759,-674441,0.06190442411
4820,817,44894,48594,0.08241635853,3700,"Congressional District 20 (115th Congress), Texas",20,48,4820,Congressional District 20,Texas,5001500US4820,762155,41124,-0.9460424717,-721031,0.05395752832
4821,818,45829,63979,0.3960374435,18150,"Congressional District 21 (115th Congress), Texas",21,48,4821,Congressional District 21,Texas,5001500US4821,762036,26378,-0.9653848375,-735658,0.03461516254
4822,819,78222,90194,0.1530515712,11972,"Congressional District 22 (115th Congress), Texas",22,48,4822,Congressional District 22,Texas,5001500US4822,814295,110473,-0.8643329506,-703822,0.1356670494
4823,820,52083,51081,-0.01923852313,-1002,"Congressional District 23 (115th Congress), Texas",23,48,4823,Congressional District 23,Texas,5001500US4823,741364,25324,-0.9658413411,-716040,0.0341586589
4824,821,46466,67197,0.4461541772,20731,"Congressional District 24 (115th Congress), Texas",24,48,4824,Congressional District 24,Texas,5001500US4824,759717,84115,-0.8892811402,-675602,0.1107188598
4825,822,45164,63799,0.4126073864,18635,"Congressional District 25 (115th Congress), Texas",25,48,4825,Congressional District 25,Texas,5001500US4825,746615,53729,-0.9280365382,-692886,0.07196346176
4826,823,63039,81425,0.291660718,18386,"Congressional District 26 (115th Congress), Texas",26,48,4826,Congressional District 26,Texas,5001500US4826,796179,59649,-0.9250809177,-736530,0.07491908227
4827,824,33490,51398,0.5347267841,17908,"Congressional District 27 (115th Congress), Texas",27,48,4827,Congressional District 27,Texas,5001500US4827,726807,38644,-0.9468304516,-688163,0.05316954845
4828,825,57997,45253,-0.2197355036,-12744,"Congressional District 28 (115th Congress), Texas",28,48,4828,Congressional District 28,Texas,5001500US4828,735440,30864,-0.9580332862,-704576,0.0419667138
4829,826,36106,39571,0.09596742924,3465,"Congressional District 29 (115th Congress), Texas",29,48,4829,Congressional District 29,Texas,5001500US4829,729879,77945,-0.8932083263,-651934,0.1067916737
4830,827,36792,42708,0.1607958252,5916,"Congressional District 30 (115th Congress), Texas",30,48,4830,Congressional District 30,Texas,5001500US4830,745784,328105,-0.5600535812,-417679,0.4399464188
4831,828,48231,65636,0.3608674919,17405,"Congressional District 31 (115th Congress), Texas",31,48,4831,Congressional District 31,Texas,5001500US4831,782478,89621,-0.8854651505,-692857,0.1145348495
4832,829,44532,65544,0.4718404743,21012,"Congressional District 32 (115th Congress), Texas",32,48,4832,Congressional District 32,Texas,5001500US4832,742056,96229,-0.8703211078,-645827,0.1296788922
4833,830,28334,36755,0.2972047717,8421,"Congressional District 33 (115th Congress), Texas",33,48,4833,Congressional District 33,Texas,5001500US4833,719958,115467,-0.8396198112,-604491,0.1603801888
4834,831,36480,36417,-0.001726973684,-63,"Congressional District 34 (115th Congress), Texas",34,48,4834,Congressional District 34,Texas,5001500US4834,718321,10075,-0.9859742371,-708246,0.01402576286
4835,832,33720,43311,0.284430605,9591,"Congressional District 35 (115th Congress), Texas",35,48,4835,Congressional District 35,Texas,5001500US4835,777259,73531,-0.9053970427,-703728,0.09460295732
4836,833,37017,56549,0.5276494584,19532,"Congressional District 36 (115th Congress), Texas",36,48,4836,Congressional District 36,Texas,5001500US4836,724245,65831,-0.9091039634,-658414,0.09089603656
4901,834,37813,62875,0.6627879301,25062,"Congressional District 1 (115th Congress), Utah",1,49,4901,Congressional District 1,Utah,5001500US4901,730389,7629,-0.989554881,-722760,0.01044511897
4902,835,35170,56311,0.6011088996,21141,"Congressional District 2 (115th Congress), Utah",2,49,4902,Congressional District 2,Utah,5001500US4902,727562,9041,-0.9875735676,-718521,0.01242643239
4903,836,60018,66478,0.1076343764,6460,"Congressional District 3 (115th Congress), Utah",3,49,4903,Congressional District 3,Utah,5001500US4903,732869,4297,-0.994136742,-728572,0.005863257963
4904,837,45455,65081,0.4317676823,19626,"Congressional District 4 (115th Congress), Utah",4,49,4904,Congressional District 4,Utah,5001500US4904,757607,11545,-0.9847612284,-746062,0.01523877155
5000,838,42935,56104,0.3067194596,13169,"Congressional District (at Large) (115th Congress), Vermont",0,50,5000,Congressional District (at Large),Vermont,5001500US5000,626249,7404,-0.9881772266,-618845,0.01182277337
5101,839,67174,80492,0.198261232,13318,"Congressional District 1 (115th Congress), Virginia",1,51,5101,Congressional District 1,Virginia,5001500US5101,767681,127204,-0.8343009662,-640477,0.1656990338
5102,840,46063,63681,0.3824761739,17618,"Congressional District 2 (115th Congress), Virginia",2,51,5102,Congressional District 2,Virginia,5001500US5102,739007,147943,-0.7998083915,-591064,0.2001916085
5103,841,39714,50822,0.279699854,11108,"Congressional District 3 (115th Congress), Virginia",3,51,5103,Congressional District 3,Virginia,5001500US5103,738466,341579,-0.5374478988,-396887,0.4625521012
5104,842,37622,52464,0.3945032162,14842,"Congressional District 4 (115th Congress), Virginia",4,51,5104,Congressional District 4,Virginia,5001500US5104,754069,312994,-0.5849265783,-441075,0.4150734217
5105,843,32557,50005,0.5359216144,17448,"Congressional District 5 (115th Congress), Virginia",5,51,5105,Congressional District 5,Virginia,5001500US5105,731805,145359,-0.8013692172,-586446,0.1986307828
5106,844,31231,49798,0.5945054593,18567,"Congressional District 6 (115th Congress), Virginia",6,51,5106,Congressional District 6,Virginia,5001500US5106,744504,80436,-0.891960285,-664068,0.108039715
5107,845,53531,70994,0.326222189,17463,"Congressional District 7 (115th Congress), Virginia",7,51,5107,Congressional District 7,Virginia,5001500US5107,762523,136300,-0.8212512934,-626223,0.1787487066
5108,846,63965,100649,0.5735011334,36684,"Congressional District 8 (115th Congress), Virginia",8,51,5108,Congressional District 8,Virginia,5001500US5108,778376,107705,-0.8616285703,-670671,0.1383714297
5109,847,27331,40855,0.4948227288,13524,"Congressional District 9 (115th Congress), Virginia",9,51,5109,Congressional District 9,Virginia,5001500US5109,717480,39174,-0.9454005687,-678306,0.05459943134
5110,848,93562,116069,0.2405570638,22507,"Congressional District 10 (115th Congress), Virginia",10,51,5110,Congressional District 10,Virginia,5001500US5110,796568,54460,-0.9316317,-742108,0.06836830001
5111,849,85434,105024,0.2292998104,19590,"Congressional District 11 (115th Congress), Virginia",11,51,5111,Congressional District 11,Virginia,5001500US5111,779822,103198,-0.8676646722,-676624,0.1323353278
5301,850,86783,85293,-0.01716926126,-1490,"Congressional District 1 (115th Congress), Washington",1,53,5301,Congressional District 1,Washington,5001500US5301,716614,8774,-0.9877563095,-707840,0.01224369047
5302,851,53064,61475,0.1585067089,8411,"Congressional District 2 (115th Congress), Washington",2,53,5302,Congressional District 2,Washington,5001500US5302,706518,20640,-0.9707863069,-685878,0.02921369307
5303,852,41335,56436,0.3653320431,15101,"Congressional District 3 (115th Congress), Washington",3,53,5303,Congressional District 3,Washington,5001500US5303,699966,10174,-0.9854650083,-689792,0.0145349917
5304,853,40603,51434,0.2667536882,10831,"Congressional District 4 (115th Congress), Washington",4,53,5304,Congressional District 4,Washington,5001500US5304,704697,8248,-0.9882956789,-696449,0.01170432115
5305,854,30261,48516,0.6032517101,18255,"Congressional District 5 (115th Congress), Washington",5,53,5305,Congressional District 5,Washington,5001500US5305,691150,11010,-0.9840700282,-680140,0.01592997179
5306,855,39416,57285,0.4533438198,17869,"Congressional District 6 (115th Congress), Washington",6,53,5306,Congressional District 6,Washington,5001500US5306,686051,24226,-0.9646877564,-661825,0.03531224355
5307,856,33345,75568,1.266246814,42223,"Congressional District 7 (115th Congress), Washington",7,53,5307,Congressional District 7,Washington,5001500US5307,729532,31039,-0.9574535456,-698493,0.04254645444
5308,857,61080,75953,0.2435003274,14873,"Congressional District 8 (115th Congress), Washington",8,53,5308,Congressional District 8,Washington,5001500US5308,713794,20374,-0.9714567508,-693420,0.02854324917
5309,858,39551,68915,0.7424338196,29364,"Congressional District 9 (115th Congress), Washington",9,53,5309,Congressional District 9,Washington,5001500US5309,714192,78064,-0.8906960593,-636128,0.1093039407
5310,859,54624,59107,0.08207015231,4483,"Congressional District 10 (115th Congress), Washington",10,53,5310,Congressional District 10,Washington,5001500US5310,710632,44441,-0.9374627093,-666191,0.06253729075
5401,860,27296,43285,0.5857634818,15989,"Congressional District 1 (115th Congress), West Virginia",1,54,5401,Congressional District 1,West Virginia,5001500US5401,617075,15639,-0.9746562411,-601436,0.02534375886
5402,861,39161,47628,0.2162100049,8467,"Congressional District 2 (115th Congress), West Virginia",2,54,5402,Congressional District 2,West Virginia,5001500US5402,625142,25081,-0.9598795154,-600061,0.04012048463
5403,862,25384,37243,0.4671840529,11859,"Congressional District 3 (115th Congress), West Virginia",3,54,5403,Congressional District 3,West Virginia,5001500US5403,603875,22585,-0.9625998758,-581290,0.0374001242
5501,863,28327,60528,1.136759982,32201,"Congressional District 1 (115th Congress), Wisconsin",1,55,5501,Congressional District 1,Wisconsin,5001500US5501,715455,38862,-0.9456821184,-676593,0.05431788163
5502,864,29733,60946,1.049776343,31213,"Congressional District 2 (115th Congress), Wisconsin",2,55,5502,Congressional District 2,Wisconsin,5001500US5502,741376,31953,-0.9569004122,-709423,0.04309958779
5503,865,30660,50985,0.6629158513,20325,"Congressional District 3 (115th Congress), Wisconsin",3,55,5503,Congressional District 3,Wisconsin,5001500US5503,718576,7645,-0.9893609027,-710931,0.01063909733
5504,866,27143,40400,0.4884132189,13257,"Congressional District 4 (115th Congress), Wisconsin",4,55,5504,Congressional District 4,Wisconsin,5001500US5504,715266,243228,-0.6599474881,-472038,0.3400525119
5505,867,39851,65816,0.6515520313,25965,"Congressional District 5 (115th Congress), Wisconsin",5,55,5505,Congressional District 5,Wisconsin,5001500US5505,719342,14380,-0.9800095087,-704962,0.01999049131
5506,868,30379,55310,0.8206655914,24931,"Congressional District 6 (115th Congress), Wisconsin",6,55,5506,Congressional District 6,Wisconsin,5001500US5506,712501,11166,-0.984328443,-701335,0.01567155695
5507,869,40841,50744,0.2424769227,9903,"Congressional District 7 (115th Congress), Wisconsin",7,55,5507,Congressional District 7,Wisconsin,5001500US5507,709035,5195,-0.9926731403,-703840,0.007326859746
5508,870,26332,55380,1.103144463,29048,"Congressional District 8 (115th Congress), Wisconsin",8,55,5508,Congressional District 8,Wisconsin,5001500US5508,723247,9301,-0.9871399397,-713946,0.01286006026
5600,871,44079,59143,0.3417500397,15064,"Congressional District (at Large) (115th Congress), Wyoming",0,56,5600,Congressional District (at Large),Wyoming,5001500US5600,583029,6435,-0.9889628132,-576594,0.01103718683